Symbol	Description
1AD	Adalta Limited
1AG	Alterra Limited
1AL	Oneall International Limited
1PG	1-page Limited
1ST	1st Available Ltd
3DP	Pointerra Limited
3PL	3p Learning Limited..
4CE	Force Commodities Limited
4DS	4ds Memory Limited
5GN	5g Networks Limited
88E	88 Energy Limited
8CO	8common Limited
8COO	8common Limited
8EC	8ip Emerging Companies Limited
8IH	8i Holdings Ltd
9SP	9 Spokes International Limited
A1C	Aic Resources Limited
A200	A200
A2M	The A2 Milk Company Limited
A2MKOB	The A2 Milk Company Limited
A2MKOC	The A2 Milk Company Limited
A2MKOD	The A2 Milk Company Limited
A2MKOE	The A2 Milk Company Limited
A2MKOG	The A2 Milk Company Limited
A2MKOH	The A2 Milk Company Limited
A2MKOI	The A2 Milk Company Limited
A2MKOP	The A2 Milk Company Limited
A2MKOQ	The A2 Milk Company Limited
A2MKOR	The A2 Milk Company Limited
A2MKOS	The A2 Milk Company Limited
A3D	Aurora Labs Limited
A3DO	Aurora Labs Limited
AAA	Betashares Australian High Interest Cash Etf
AAC	Australian Agricultural Company Ltd
AACKOB	Australian Agricultural Company Limited.
AACKOC	Australian Agricultural Company Limited.
AAD	Ardent Leisure Group
AADKOA	Ardent Leisure Group
AADKOC	Ardent Leisure Group
AADKOD	Ardent Leisure Group
AADKOE	Ardent Leisure Group
AADKOP	Ardent Leisure Group
AADKOR	Ardent Leisure Group
AAJ	Aruma Resources Limited
AAP	Australian Agricultural Projects Limited
AAR	Anglo Australian Resources NL
AAU	Adcorp Australia Ltd
AB1	Animoca Brands Corporation Limited
ABA	Auswide Bank Ltd
ABC	Adelaide Brighton Ltd
ABCKOA	Adelaide Brighton Limited
ABCKOE	Adelaide Brighton Limited
ABCKOQ	Adelaide Brighton Limited
ABL	Abilene Oil And Gas Limited
ABP	Abacus Property Group
ABR	American Pacific Borate & Lithium Limited
ABT	Abundant Produce Limited
ABV	Advanced Braking Technology Ltd
ABW	Aurora Buy Write Income Trust
ABX	Abelle Ltd
AC8	Auscann Group Holdings Ltd
ACB	A-Cap Resources Ltd
ACF	Acumen Capital Property Securities Fund
ACL	Alchemia Ltd
ACO	Australian Careers Network Limited
ACP	Audalia Resources Limited
ACQ	Acorn Capital Investment Fund Limited
ACR	Acrux Ltd
ACS	Accent Resources NL
ACW	Actinogen Ltd
ACWOB	Actinogen Medical Limited
AD1	Applydirect Limited
AD8	Audinate Group Limited
ADA	Adacel Technologies Ltd
ADD	Adavale Resources Ltd
ADH	Adairs Limited
ADJ	Adslot Ltd
ADN	Adelaide Resources Ltd
ADNOB	Andromeda Metals Limited
ADO	
ADR	Adherium Limited
ADT	Advent Ltd
ADV	Australian Development Capital Fund
ADX	Audax Resources Ltd
ADY	Admiralty Resources NL
AEB	Algae.tec Limited
AEBO	Algae.tec Limited
AEE	Aura Energy Ltd
AEF	Australian Ethical Investments Ltd
AEG	Absolute Equity Performance Fund Limited
AEI	Aeris Technologies Ltd
AER	Aeeris Ltd
AEV	Avenira Limited
AFA	ASF Group Ltd
AFG	Allco Finance Group Ltd
AFI	Australian Foundation Invest Ltd
AFP	Aft Pharmaceuticals Limited
AFR	African Energy Resources (Guernsey) Ltd
AFT	AFT Corporation Ltd
AGD	Austral Gold Ltd
AGE	Alligator Energy Limited
AGEO	Alligator Energy Limited
AGG	Anglogold Ashanti Ltd (Sth Afr CUFS)
AGI	Ainsworth Game Technology Ltd
AGJ	Agricultural Land Trust
AGL	AGL Energy Limited
AGLHA	Agl Energy Limited.
AGLKOB	Agl Energy Limited.
AGLKOC	Agl Energy Limited.
AGLKOD	Agl Energy Limited.
AGLKOG	Agl Energy Limited.
AGLKOP	Agl Energy Limited.
AGLKOT	Agl Energy Limited.
AGM	Allegiance Mining NL
AGO	Atlas Gold Ltd
AGR	Aguia Resources Limited
AGS	Alliance Resources Ltd
AGY	Argosy Minerals Inc (CUFS)
AHF	Australian Dairy Farms Group
AHG	Advance Healthcare Group Ltd
AHGKOB	Automotive Holdings Group Limited.
AHGKOC	Automotive Holdings Group Limited.
AHGKOR	Automotive Holdings Group Limited.
AHK	Ark Mines Limited
AHL	Ahalife Holdings Limited
AHN	Athena Resources Ltd
AHQ	Allegiance Coal Limited
AHR	Anchor Resources Ltd
AHX	Apiam Animal Health Limited
AHY	Asaleo Care Limited
AHZ	Allied Healthcare Group Ltd
AIA	Auckland International Airport Ltd
AIB	Aurora Infrastructure Buy Write Income Trust
AIQ	Alternative Investment Trust
AIR	Astivita Renewables Limited
AIS	Automotive Industrial & Mining Supplies
AIV	Activex Ltd
AIY	Authorised Investment Fund Ltd
AIZ	Air New Zealand Ltd
AJC	Acacia Coal Limited
AJD	Asia Pacific Data Centre Group
AJJ	Asian Centre For Liver Diseases And Transplantation Limited
AJL	AJ Lucas Group Ltd
AJM	Altura Mining Limited
AJQ	Armour Energy Limited
AJX	Alexium International Group Limited
AJY	Asaplus Resources Limited
AKF	
AKG	AKG
AKM	Aspire Mining Limited
AKMOA	Aspire Mining Limited
AKN	Auking Mining Limited
AKP	Audio Pixels Holdings Limited
AL8	Alderan Resources Limited
ALC	Alcidion Group Limited
ALF	Australian Leaders Fund Ltd
ALI	Argo Global Listed Infrastructure Limited
ALK	Alkane Exploration Ltd
ALL	Aristocrat Leisure Ltd
ALLKOB	Aristocrat Leisure Limited
ALLKOC	Aristocrat Leisure Limited
ALLKOD	Aristocrat Leisure Limited
ALLKOG	Aristocrat Leisure Limited
ALLKOS	Aristocrat Leisure Limited
ALLKOU	Aristocrat Leisure Limited
ALLKOW	Aristocrat Leisure Limited
ALQ	Als Limited
ALQKOB	Als Limited
ALQKOE	Als Limited
ALQKOF	Als Limited
ALQKOR	Als Limited
ALQKOT	Als Limited
ALQKOU	Als Limited
ALT	Analytica Ltd
ALU	Altium Ltd
ALUKOA	Altium Limited
ALUKOB	Altium Limited
ALUKOC	Altium Limited
ALX	Allstate Explorations NL
ALY	Alchemy Resources Ltd
AMA	Allomak Ltd
AMB	Ambition Group Ltd
AMC	Amcor Ltd
AMCBOD	Amcor Limited
AMCBOQ	Amcor Limited
AMCBOR	Amcor Limited
AMCKOA	Amcor Limited
AMCKOC	Amcor Limited
AMCKOQ	Amcor Limited
AMCKOS	Amcor Limited
AMD	Arrow Minerals Ltd
AMDOA	Arrow Minerals Ltd
AME	Austmet Resources Ltd
AMG	Alcaston Mining NL
AMH	AMCIL Ltd
AMI	Aurelia Metals Limited
AML	AMRAD Corporation Ltd
AMN	Agrimin Limited
AMO	Ambertech Ltd
AMP	AMP Ltd
AMPBOD	Amp Limited
AMPBOE	Amp Limited
AMPBOH	Amp Limited
AMPBON	Amp Limited
AMPBOU	Amp Limited
AMPBOY	Amp Limited
AMPHA	Amp Limited
AMPKOA	Amp Limited
AMPKOB	Amp Limited
AMPKOH	Amp Limited
AMPKOJ	Amp Limited
AMPKOQ	Amp Limited
AMPKOS	Amp Limited
AMPKOT	Amp Limited
AMPKOV	Amp Limited
AMPLOA	Amp Limited
AMPLOB	Amp Limited
AMPLOD	Amp Limited
AMPLOQ	Amp Limited
AMPLOR	Amp Limited
AMPLOU	Amp Limited
AMPLOV	Amp Limited
AMPPA	Amp Limited
AMT	Advanced Surgical Design & Manufacture Ltd
ANG	Austin Engineering Ltd
ANL	Anaconda Nickel Nl
ANN	Ansell Ltd
ANNKOB	Ansell Limited
ANNKOC	Ansell Limited
ANNKOP	Ansell Limited
ANNKOR	Ansell Limited
ANO	Advanced Nanotechnology Ltd
ANP	Antisense Therapeutics Ltd
ANPOB	Antisense Therapeutics Limited
ANQ	Anaeco Ltd
ANR	Anatara Lifesciences Ltd
ANS	Austsino Resources Group Limited
ANW	Ausnico Limited
ANZ	Australia & NZ Banking Group Ltd
ANZBOA	Australia And New Zealand Banking Group Limited
ANZBOE	Australia And New Zealand Banking Group Limited
ANZBOG	Australia And New Zealand Banking Group Limited
ANZBON	Australia And New Zealand Banking Group Limited
ANZBOQ	Australia And New Zealand Banking Group Limited
ANZBOR	Australia And New Zealand Banking Group Limited
ANZKOC	Australia And New Zealand Banking Group Limited
ANZKOG	Australia And New Zealand Banking Group Limited
ANZKOI	Australia And New Zealand Banking Group Limited
ANZKOL	Australia And New Zealand Banking Group Limited
ANZKOM	Australia And New Zealand Banking Group Limited
ANZKON	Australia And New Zealand Banking Group Limited
ANZKOP	Australia And New Zealand Banking Group Limited
ANZKOR	Australia And New Zealand Banking Group Limited
ANZKOU	Australia And New Zealand Banking Group Limited
ANZKOV	Australia And New Zealand Banking Group Limited
ANZLOA	Australia And New Zealand Banking Group Limited
ANZLOB	Australia And New Zealand Banking Group Limited
ANZLOD	Australia And New Zealand Banking Group Limited
ANZLOF	Australia And New Zealand Banking Group Limited
ANZLOP	Australia And New Zealand Banking Group Limited
ANZLOT	Australia And New Zealand Banking Group Limited
ANZLOU	Australia And New Zealand Banking Group Limited
ANZLOV	Australia And New Zealand Banking Group Limited
ANZLOW	Australia And New Zealand Banking Group Limited
ANZMOR	Australia And New Zealand Banking Group Limited
ANZMOT	Australia And New Zealand Banking Group Limited
ANZPC	Australia And New Zealand Banking Group Limited
ANZPD	Australia And New Zealand Banking Group Limited
ANZPE	Australia And New Zealand Banking Group Limited
ANZPF	Australia And New Zealand Banking Group Limited
ANZPG	Australia And New Zealand Banking Group Limited
ANZPH	Australia And New Zealand Banking Group Limited
ANZQOJ	Australia And New Zealand Banking Group Limited
AO1	Assetowl Limited
AO1O	Assetowl Limited
AO1OA	Assetowl Limited
AOA	
AOD	Aurora Sandringham Dividend Income Trust
AOF	AMP Office Trust
AOG	Aveo Group
AOGKOC	Aveo Group
AOK	Austex Oil Ltd
AON	Apollo Minerals Ltd
AOP	Apollo Life Sciences Ltd
AOU	Auroch Minerals Nl
AOW	American Patriot Oil & Gas Limited
AOWOA	American Patriot Oil & Gas Limited
AOWOB	American Patriot Oil & Gas Limited
APA	Australian Pipeline Trust
APABOD	Apa Group
APABOU	Apa Group
APAKOC	Apa Group
APAKOD	Apa Group
APAKOR	Apa Group
APC	Australian Potash Limited
APCOA	Australian Potash Limited
APD	APN Property Group Ltd
APE	AP Eagers Holdings Ltd
APG	Austpac Gold Resources NL
API	Australian Pharmaceutical Ind Ltd
APL	Australian Plantation Timber Ltd
APLO	Antipodes Global Investment Company Ltd
APO	Apn Outdoor Group Limited
APOKOB	Apn Outdoor Group Limited
APOKOC	Apn Outdoor Group Limited
APOKOD	Apn Outdoor Group Limited
APOKOQ	Apn Outdoor Group Limited
APT	Afterpay Touch Group Limited
APW	Aims Property Securities Fund
APX	Appen Limited
APZ	Aspen Group
AQC	Australian Pacific Coal Limited
AQD	AusQuest Ltd
AQF	Australian Governance Masters Index Fund Limited
AQG	Alacer Gold Corp
AQI	Alicanto Minerals Limited
AQIO	Alicanto Minerals Limited
AQS	Aquis Entertainment Limited
AQX	Alice Queen Limited
AQZ	Alliance Aviation Services Limited
ARA	Ariadne Australia Ltd
ARB	Arb Corporation Limited.
ARC	Amalg Resources Nl
ARCO	Australian Rural Capital Limited
ARD	Argent Minerials Lts
ARDO	Argent Minerials Lts
ARE	Argonaut Resources NL
ARF	Arena Reit
ARG	Argo Investments Ltd
ARH	Australasian Resources Ltd
ARI	Arrium Limited
ARL	Austrim
ARM	Aurora Minerals Ltd
ARO	Astro Diamond Mines NL
ARQ	ARC Energy Ltd
ARS	Alt Resources Limited
ARU	Arafura Resources NL
ARV	Artemis Resources Ltd
ARX	Austindo Resources Corporation NL
AS1	Angel Seafood Holdings Ltd
ASB	Austal Ltd
ASG	Autosports Group Limited.
ASH	Ashley Services Group Limited
ASL	Ausdrill Ltd
ASN	Anson Resources Limited
ASNOB	Anson Resources Limited
ASP	Aspermont Ltd
AST	Ausnet Services
ASTKOB	Ausnet Services Limited
ASW	Advanced Share Registry Ltd
ASX	Australian Stock Exchange Ltd
ASXKOB	Asx Limited
ASXKOC	Asx Limited
ASXKOP	Asx Limited
ASXKOR	Asx Limited
ASXKOT	Asx Limited
ASY	Assemblebay Limited
ATA	Atc Alloys Ltd
ATC	Advantage Telecommunications Ltd
ATL	Auto Enterprises Ltd
ATM	Aneka Tambang (Persero) Tbk (Indo)
ATP	Atlas Pacific Ltd
ATR	Astron Ltd
ATS	Australis Oil & Gas Limited
ATT	Amnett Ltd
ATU	Atrum Coal Nl
ATUO	Atrum Coal Limited
AU1	Ausnet Financial Services Limited
AU1O	Ausnet Financial Services Limited
AU8	Aumake International Limited
AUB	Austbrokers Holdings Ltd
AUC	Ausgold Limited
AUH	Australian Healthcare Technology Ltd
AUI	Australian United Investment Ltd
AUL	Australian United Gold Ltd
AUMF	AUMF
AUP	Aurora Property Income Trust
AUQ	Alara Uranium Ltd
AUR	Auris Minerals Limited
AUST	AUST
AUZ	Australian Mines Ltd
AVA	Aviva Corporation Ltd
AVB	Avanco Resources Ltd
AVC	Australian Visual Communications
AVD	Advance Energy Ltd
AVG	Australian Vintage Ltd t/over by SWS
AVH	Avita Medical Ltd
AVJ	AV Jennings Homes Ltd
AVL	Anvil Mining Nl
AVLO	
AVN	Avon Resources Ltd
AVQ	Axiom Mining Ltd
AVQO	Axiom Mining Limited
AVW	Avira Energy Limited
AVZ	Avonlea Minerals Ltd
AVZO	Avz Minerals Limited
AWC	Alumina Ltd
AWCKOA	Alumina Limited
AWCKOB	Alumina Limited
AWCKOC	Alumina Limited
AWCKOD	Alumina Limited
AWCKOE	Alumina Limited
AWCKOH	Alumina Limited
AWCKOS	Alumina Limited
AWCKOT	Alumina Limited
AWCKOU	Alumina Limited
AWCKOX	Alumina Limited
AWN	Arowana International Limited
AWV	Anova Metals Limited
AWY	Australian Whisky Holdings Limited
AX1	Accent Group Limited
AX8	Accelerate Resources Limited
AXE	Archer Exploration Ltd
AXI	Axiom Properties Ltd
AXL	Aucxis
AXLHA	Axsesstoday Limited
AXP	Airxpanders Inc
AXT	Argo Exploration Ltd
AYF	Australian Enhanced Income Fund
AYI	A1 Investments & Resources Ltd
AYK	Australian Masters Yield Fund No 4 Limited
AYM	Altius Mining Limited
AYR	Alloy Resources Ltd
AYS	Amaysim Australia Limited
AYUHB	Australian Unity Limited
AYZ	Australian Masters Yield Fund No 5 Limited
AZI	Alta Zinc Limited
AZJ	Aurizon Holdings Limited
AZJKOA	Aurizon Holdings Limited
AZJKOB	Aurizon Holdings Limited
AZJKOE	Aurizon Holdings Limited
AZJKOP	Aurizon Holdings Limited
AZJKOQ	Aurizon Holdings Limited
AZJKOR	Aurizon Holdings Limited
AZJKOS	Aurizon Holdings Limited
AZM	Azumah Resources Ltd
AZS	Azure Minerals Ltd
AZV	Azure Healthcare Limited
AZY	Antipa Minerals Limited
B2Y	Bounty Mining Limited
BAF	Blue Sky Alternatives Access Fund Limited
BAH	Bojun Agriculture Holdings Limited
BAL	Bellamys Australia Limited
BALKOB	Bellamys Australia Limited
BALKOC	Bellamys Australia Limited
BALKOD	Bellamys Australia Limited
BAP	Burson Group Limited
BAPKOA	Bapcor Limited
BAPKOB	Bapcor Limited
BAPKOQ	Bapcor Limited
BAR	Barra Resources ltd
BAS	Bass Strait Oil Company Ltd
BASOA	Bass Oil Limited
BAT	Battery Minerals Limited
BATO	Battery Minerals Limited
BAU	Bauxite Resources Ltd
BBL	Brisbane Broncos Ltd
BBN	Baby Bunting Group Limited
BBOZ	BBOZ
BBR	Bora Bora Resources Limited
BBX	BBX Holdings Ltd
BC8	Black Cat Syndicate Limited
BCB	Bowen Coking Coal Limited
BCBO	Bowen Coking Coal Limited
BCI	BC Iron Ltd
BCK	Brockman Mining Limited
BCL	Betcorp Ltd
BCN	Beacon Minerals Ltd
BCNOB	Beacon Minerals Limited
BCT	Bluechiip Limited
BD1	Bard1 Life Sciences Limited
BDA	Bod Australia Limited
BDI	Blina Diamonds NL
BDR	Beadell Resources Ltd
BEAR	BEAR
BEE	Broo Ltd
BEL	Bentley International Ltd
BEM	Blackearth Minerals Nl
BEN	Bendigo Bank Ltd
BENHB	Bendigo And Adelaide Bank Limited
BENKOC	Bendigo And Adelaide Bank Limited
BENKOG	Bendigo And Adelaide Bank Limited
BENKOS	Bendigo And Adelaide Bank Limited
BENPE	Bendigo And Adelaide Bank Limited
BENPF	Bendigo And Adelaide Bank Limited
BENPG	Bendigo And Adelaide Bank Limited
BFC	Beston Global Food Company Limited
BFG	Bell Financial Group Ltd
BGA	Bega Cheese Limited
BGH	Bligh Resources Limited
BGL	Bigair Group Ltd
BGP	Briscoe Group Australasia Limited
BGS	Birimian Gold Limited
BGT	Bio-gene Technology Ltd
BGTO	Bio-gene Technology Ltd
BHD	Benjamin Hornigold Limited
BHDO	Benjamin Hornigold Limited
BHL	Bidvest Plc
BHP	BHP Billiton Ltd
BHPBOA	Bhp Billiton Limited
BHPKOB	Bhp Billiton Limited
BHPKOD	Bhp Billiton Limited
BHPKOE	Bhp Billiton Limited
BHPKOF	Bhp Billiton Limited
BHPKOH	Bhp Billiton Limited
BHPKOJ	Bhp Billiton Limited
BHPKOK	Bhp Billiton Limited
BHPKOM	Bhp Billiton Limited
BHPKOQ	Bhp Billiton Limited
BHPKOR	Bhp Billiton Limited
BHPKOU	Bhp Billiton Limited
BHPKOW	Bhp Billiton Limited
BHPKOX	Bhp Billiton Limited
BHPKOZ	Bhp Billiton Limited
BHPLOB	Bhp Billiton Limited
BHPLOC	Bhp Billiton Limited
BHPLOD	Bhp Billiton Limited
BHPLOE	Bhp Billiton Limited
BHPLOG	Bhp Billiton Limited
BHPLOH	Bhp Billiton Limited
BHPLOI	Bhp Billiton Limited
BHPLON	Bhp Billiton Limited
BHPLOR	Bhp Billiton Limited
BHPLOT	Bhp Billiton Limited
BHPLOU	Bhp Billiton Limited
BHPMOD	Bhp Billiton Limited
BHPMOQ	Bhp Billiton Limited
BHPMOR	Bhp Billiton Limited
BID	Bidenergy Limited
BIDO	Bidenergy Limited
BIG	BIgShop.com.au
BILL	BILL
BIN	Bingo Industries Limited
BIQ	Buildingiq, Inc
BIR	Burswood
BIS	
BIT	Biotron Ltd
BITOA	Biotron Limited
BITOB	Biotron Limited
BKI	Brickworks Investment Company Ltd
BKL	Blackmores Laboratories Ltd
BKLKOD	Blackmores Limited
BKLKOP	Blackmores Limited
BKLKOQ	Blackmores Limited
BKM	BKM Management Ltd
BKP	Baraka Petroleum Ltd
BKT	Black Rock Mining Limited
BKTOD	Black Rock Mining Limited
BKW	Brickworks Ltd
BKY	Berkeley Resources Ltd
BLA	Blue Sky Alternative Investments Limited
BLD	Boral Ltd
BLDKOB	Boral Limited.
BLDKOD	Boral Limited.
BLDKOP	Boral Limited.
BLDKOS	Boral Limited.
BLDKOU	Boral Limited.
BLG	Blugass Ltd
BLK	Blackham Resources Ltd
BLKOA	Blackham Resources Limited
BLT	Benitec Ltd
BLX	Beacon Lighting Group Limited
BLY	Boart Longyear Ltd
BLYO	Boart Longyear Limited
BLZ	Blaze International Ltd
BMG	Brazilian Metals Group Limited.
BMGOA	Bmg Resources Limited
BMH	Baumart Holdings Limited
BMN	Bannerman Resources Ltd
BMP	Buymyplace.com.au Limited
BMT	Berkut Minerals Limited
BNL	Balkans Gold Ltd
BNO	Bionomics Ltd
BNR	Bulletin Resources Limited
BOA	Boadicea Resources Limited
BOC	Bougainville Copper Ltd (PNG)
BOE	Boss Energy Ltd
BOL	Boom Logistics Ltd
BOQ	Bank of Queensland Ltd
BOQBOD	Bank Of Queensland Limited.
BOQBON	Bank Of Queensland Limited.
BOQBOR	Bank Of Queensland Limited.
BOQKOE	Bank Of Queensland Limited.
BOQKOF	Bank Of Queensland Limited.
BOQKOP	Bank Of Queensland Limited.
BOQKOQ	Bank Of Queensland Limited.
BOQKOR	Bank Of Queensland Limited.
BOQPE	Bank Of Queensland Limited.
BOT	Botanix Pharmaceuticals Ltd
BPG	Byte Power Group Ltd
BPH	BioPharmica Ltd
BPL	Broken Hill Prospecting Limited
BPLO	Broken Hill Prospecting Limited
BPP	Babylon Pump & Power Limited
BPPOA	Babylon Pump & Power Limited
BPT	Beach Petroleum Ltd
BPTKOA	Beach Energy Limited
BPTKOB	Beach Energy Limited
BPTKOC	Beach Energy Limited
BPTKOP	Beach Energy Limited
BPTKOS	Beach Energy Limited
BRB	Breaker Resources Nl
BRBCA	Breaker Resources Nl
BRC	Brain Resource Company Ltd (The)
BRG	Breville Group Ltd
BRI	Breakwater Island Trust
BRK	BreakFree Ltd
BRKO	Brookside Energy Limited
BRL	Brl Hardy
BRN	Brainchip Holdings Ltd
BRO	BroadTel Communications Ltd
BRU	Buru Energy Ltd
BSA	Broadcast Services Australia Ltd
BSE	BSE
BSL	BlueScope Steel Ltd
BSLKOA	Bluescope Steel Limited
BSLKOD	Bluescope Steel Limited
BSLKOE	Bluescope Steel Limited
BSLKOP	Bluescope Steel Limited
BSLKOQ	Bluescope Steel Limited
BSLKOS	Bluescope Steel Limited
BSM	Bass Metals Ltd
BSMOB	Bass Metals Ltd
BSN	Bisan Ltd
BSP	Black Star Petroleum Limited
BSR	Bassari Resources Ltd
BSROB	Bassari Resources Limited
BST	Barrack St Investments Limited
BSX	Blackstone Minerals Limited
BTC	BioTech Capital Ltd
BTH	Bigtincan Holdings Limited
BTI	Bailador Technology Investments Limited
BUB	Bubs Australia Limited
BUD	Buddy Platform Ltd
BUG	Buderim Ginger Ltd
BUL	Blue Energy Ltd
BUX	Buxton Resources Ltd
BUY	Bounty Oil & Gas NL
BVS	Bravura Solutions Limited.
BWF	Blackwall Property Funds Limited
BWP	Bunnings Warehouse Property Trust
BWR	Blackwall Property Trust
BWX	Bwx Limited
BXB	Brambles Ltd
BXBBON	Brambles Limited
BXBBOP	Brambles Limited
BXBKOB	Brambles Limited
BXBKOC	Brambles Limited
BXBKOE	Brambles Limited
BXBKOP	Brambles Limited
BXBKOR	Brambles Limited
BXN	Bioxyne Limited
BYE	Byron Energy Limited
BYH	Bryah Resources Limited
BYHO	Bryah Resources Limited
BYI	Beyond International Ltd
C6C	Copper Mountain Mining Corporation
CA8	Coassets Limited.
CA8O	Coassets Limited.
CAA	Capral Aluminium Ltd
CAB	Cabcharge Australia Ltd
CAD	Caeneus Minerals Ltd
CADO	Caeneus Minerals Ltd
CAE	Cannindah Resources Limited
CAF	Centrepoint Alliance Ltd
CAG	Cape Range Wireless Ltd
CAI	Casinos Austria International
CAIO	Calidus Resources Limited
CAJ	Capitol Health Ltd
CAM	Clime Capital Ltd
CAMG	Clime Capital Limited
CAN	Cann Group Limited
CAP	Carpentaria Exploration Ltd
CAQ	Cell Aquaculture Ltd
CAR	Carsales.com Limited.
CARKOD	Carsales.com Limited.
CARKOQ	Carsales.com Limited.
CARKOR	Carsales.com Limited.
CAS	Crusader Holdings NL
CAT	Catuity Inc (USA)
CAV	Carnavale Resources Ltd
CAY	Canyon Resources Ltd
CAZ	Cazaly Resources Ltd
CAZO	CAZO
CBA	Commonwealth Bank Ltd
CBABOA	Commonwealth Bank Of Australia.
CBABOB	Commonwealth Bank Of Australia.
CBABOD	Commonwealth Bank Of Australia.
CBABOH	Commonwealth Bank Of Australia.
CBABOK	Commonwealth Bank Of Australia.
CBABON	Commonwealth Bank Of Australia.
CBABOR	Commonwealth Bank Of Australia.
CBAKOB	Commonwealth Bank Of Australia.
CBAKOC	Commonwealth Bank Of Australia.
CBAKOD	Commonwealth Bank Of Australia.
CBAKOE	Commonwealth Bank Of Australia.
CBAKOF	Commonwealth Bank Of Australia.
CBAKOH	Commonwealth Bank Of Australia.
CBAKOK	Commonwealth Bank Of Australia.
CBAKOM	Commonwealth Bank Of Australia.
CBAKOR	Commonwealth Bank Of Australia.
CBAKOT	Commonwealth Bank Of Australia.
CBAKOV	Commonwealth Bank Of Australia.
CBAKOW	Commonwealth Bank Of Australia.
CBAKOX	Commonwealth Bank Of Australia.
CBAKOY	Commonwealth Bank Of Australia.
CBAKOZ	Commonwealth Bank Of Australia.
CBALOA	Commonwealth Bank Of Australia.
CBALOB	Commonwealth Bank Of Australia.
CBALOD	Commonwealth Bank Of Australia.
CBALOF	Commonwealth Bank Of Australia.
CBALOI	Commonwealth Bank Of Australia.
CBALOJ	Commonwealth Bank Of Australia.
CBALOP	Commonwealth Bank Of Australia.
CBALOQ	Commonwealth Bank Of Australia.
CBALOT	Commonwealth Bank Of Australia.
CBALOU	Commonwealth Bank Of Australia.
CBALOV	Commonwealth Bank Of Australia.
CBAMOP	Commonwealth Bank Of Australia.
CBAMOQ	Commonwealth Bank Of Australia.
CBAPC	Commonwealth Bank Of Australia.
CBAPD	Commonwealth Bank Of Australia.
CBAPE	Commonwealth Bank Of Australia.
CBAPF	Commonwealth Bank Of Australia.
CBAPG	Commonwealth Bank Of Australia.
CBC	China Broadband Corporation ltd
CBL	Cbl Corporation Limited
CCA	Chimpchange Limited
CCE	Clinical Cell Culture Ltd
CCG	Commschoice Group Limited
CCJ	County Coal Limited
CCL	Coca-Cola Amatil Ltd
CCLBOR	Coca-cola Amatil Limited
CCLBOT	Coca-cola Amatil Limited
CCLKOA	Coca-cola Amatil Limited
CCLKOD	Coca-cola Amatil Limited
CCLKOP	Coca-cola Amatil Limited
CCLKOT	Coca-cola Amatil Limited
CCP	Credit Corp Group Ltd
CCPKOC	Credit Corp Group Limited
CCPKOE	Credit Corp Group Limited
CCV	Cash Converters International Ltd
CCZ	Castillo Copper Limited
CD1	Cordish Dixon Private Equity Fund I
CD2	Cordish Dixon Private Equity Fund Ii
CD3	Cordish Dixon Private Equity Fund Iii
CDA	Codan Ltd
CDB	Condor Blanco Mines Limited
CDC	Child Care Centres Australia
CDD	Cardno Ltd
CDDKOB	Cardno Limited
CDDKOQ	Cardno Limited
CDDKOR	Cardno Limited
CDG	Cleveland Mining Company Limited
CDH	Chongherr Investments Ltd
CDM	Cadence Capital Ltd
CDP	Carindale Property Trust
CDT	Castle Minerals Ltd
CDU	CuDeco Ltd
CDV	Cardinal Resources Limited
CDVOA	Cardinal Resources Limited
CDX	CDS Technologies Ltd
CDXO	Cardiex Limited
CDY	Cellmid Limited
CE1	Calima Energy Limited
CEL	CEL
CEN	Central Australian Phosphate Limited
CETF	CETF
CFE	Cape Lambert Iron Ore Ltd
CFO	Cfoam Limited
CG1	Carbonxt Group Limited
CGA	Contango Asset Management Limited
CGC	Consolidated Gaming Corporation
CGCKOB	Costa Group Holdings Limited
CGF	Challenger Financial Services Group
CGFKOA	Challenger Limited
CGFKOD	Challenger Limited
CGFKOI	Challenger Limited
CGFKOQ	Challenger Limited
CGFKOR	Challenger Limited
CGFPA	Challenger Limited
CGFPB	Challenger Limited
CGL	The Citadel Group Limited
CGM	Cougar Metals NL
CGN	Crater Gold Mining Limited
CGO	CPT Global Ltd
CGR	Careers Multilist Limited
CGS	Cogstate Ltd
CHC	Charter Hall Group
CHCKOA	Charter Hall Group
CHCKOC	Charter Hall Group
CHCKOP	Charter Hall Group
CHK	Cohiba Minerals Limited
CHKO	Cohiba Minerals Limited
CHN	Chalice Gold Mines Ltd
CHP	Chapmans Ltd
CHPO	Chapmans Limited
CHR	Chalmers Ltd
CHZ	Chesser Resources Ltd
CI1	Credit Intelligence Ltd
CIA	Champion Iron Limited
CIE	Contango Income Generator Limited
CII	CI Resources Ltd
CIM	Cimic Group Limited
CIMKOA	Cimic Group Limited
CIMKOD	Cimic Group Limited
CIMKOI	Cimic Group Limited
CIMKOP	Cimic Group Limited
CIMKOQ	Cimic Group Limited
CIMKOT	Cimic Group Limited
CIMKOU	Cimic Group Limited
CIN	Carlton Investments Ltd
CINPA	Carlton Investments PA
CIO	Connected Io Limited
CIP	Centuria Industrial Reit
CIW	Clime Investment Management Ltd
CIZ	CIZ
CKA	Cokal Limited
CKF	Collins Foods Limited
CL1	Class Limited
CL8	Collaborate Corporation Limited
CLA	Celsius Coal Limited
CLAO	Celsius Resources Limited
CLF	Community Life Ltd
CLH	Collection House Ltd
CLI	Challenger International
CLL	P Cleland Enterprises Ltd
CLQ	Clean Teq Holdings Ltd
CLT	Cellnet Group Ltd
CLV	Clover Corporation Ltd
CLW	Charter Hall Long Wale Reit
CLX	CTI Logistics Ltd
CLY	Clancy Exploration Ltd
CLYO	Clancy Exploration Limited
CLZ	Classic Minerals Ltd
CM8	Crowd Mobile Limited
CMA	Centuria Metropolitan Reit
CMC	China Magnesium Corporation Limited
CMD	Cassius Mining Limited
CMI	CMI Ltd
CMM	Capricorn Metals Ltd
CMP	Compumedics Ltd
CMW	Cromwell Corporation Ltd
CMWKOA	Cromwell Property Group
CMWKOC	Cromwell Property Group
CMY	Capital Mining Ltd
CND	Candle Australia Ltd
CNI	Centuria Capital Limited
CNJ	Conico Ltd
CNL	CNL
CNU	Chorus Limited
CNW	Cirrus Networks Holdings Limited
CNX	Carbon Energy Ltd
COB	Cobalt Blue Holdings Limited
COBO	Cobalt Blue Holdings Limited
COE	Cooper Energy Ltd
COG	Consolidated Operations Group Limited
COH	Cochlear Ltd
COHKOB	Cochlear Limited
COHKOC	Cochlear Limited
COHKOE	Cochlear Limited
COHKOG	Cochlear Limited
COHKOR	Cochlear Limited
COHKOS	Cochlear Limited
COHKOT	Cochlear Limited
COI	Comet Ridge Ltd
COM	ComOps Ltd
COO	Cosmos Ltd
COY	Coppermoly Ltd
CP1	Cannpal Animal Therapeutics Limited
CPH	CPH Investment corp
CPU	Computershare Ltd
CPUKOA	Computershare Limited.
CPUKOC	Computershare Limited.
CPUKOD	Computershare Limited.
CPUKOP	Computershare Limited.
CPUKOR	Computershare Limited.
CPV	Clearvue Technologies Limited
CQR	Charter Hall Retail Reit
CRB	Carbine Resources Ltd
CRD	Crown Diamonds NL
CRL	Comet Resources Ltd
CRM	Carbon Minerals NL (CRMCA)
CRO	Cirralto Limited
CRR	Convenience Retail Reit
CSE	Copper Strike Ltd
CSK	Crowdspark Ltd
CSL	CSL Ltd
CSLKOA	Csl Limited
CSLKOC	Csl Limited
CSLKOD	Csl Limited
CSLKOE	Csl Limited
CSLKOF	Csl Limited
CSLKOG	Csl Limited
CSLKOI	Csl Limited
CSLKOT	Csl Limited
CSLKOV	Csl Limited
CSLKOW	Csl Limited
CSLKOX	Csl Limited
CSR	CSR Ltd
CSRKOC	Csr Limited
CSRKOP	Csr Limited
CSRKOQ	Csr Limited
CSS	Clean Seas Tuna Ltd
CSV	CSG Ltd
CT1	Ccp Technologies Limited
CTD	Corporate Travel Management Limited
CTDKOA	Corporate Travel Management Limited
CTDKOB	Corporate Travel Management Limited
CTDKOC	Corporate Travel Management Limited
CTDKOD	Corporate Travel Management Limited
CTDKOF	Corporate Travel Management Limited
CTDKOG	Corporate Travel Management Limited
CTDKOQ	Corporate Travel Management Limited
CTE	Cryosite Ltd
CTL	Citect Corporation Ltd
CTLO	Centennial Mining Limited
CTM	Centaurus Metals Limited
CTMOB	Centaurus Metals Limited
CTO	Citigold Corporation Ltd
CTP	Central Petroleum Ltd
CTX	Caltex Australia Ltd
CTXBON	Caltex Australia Limited
CTXKOB	Caltex Australia Limited
CTXKOC	Caltex Australia Limited
CTXKOP	Caltex Australia Limited
CTXKOQ	Caltex Australia Limited
CTXKOZ	Caltex Australia Limited
CUE	Cue Energy Resources Ltd
CUL	Cullen Resources Ltd
CUP	Countplus Limited
CUV	Clinuvel Pharmaceuticals Ltd
CUX	Crossland Uranium Mines Ltd
CV1	Cv Check Ltd
CVC	CVC Ltd
CVCG	Cvc Limited
CVF	Contrarian Value Fund Limited
CVN	Carnarvon Petroleum Ltd
CVS	Cervantes Seafood Ltd
CVT	Covata Limited
CVV	Caravel Minerals Limited
CVW	Clearview Wealth Limited
CWL	Chant West Holdings Limited
CWN	Crown Ltd
CWNBOA	Crown Resorts Limited
CWNBON	Crown Resorts Limited
CWNBOR	Crown Resorts Limited
CWNHA	Crown Limited
CWNHB	Crown Resorts Limited
CWNKOC	Crown Limited
CWNKOF	Crown Resorts Limited
CWNKOP	Crown Limited
CWNKOR	Crown Limited
CWNKOS	Crown Resorts Limited
CWP	Cedar Woods Properties Ltd
CWX	Carawine Resources Limited
CWY	Cleanaway Waste Management Limited
CWYKOA	Cleanaway Waste Management Limited
CWYKOB	Cleanaway Waste Management Limited
CWYKOP	Cleanaway Waste Management Limited
CXL	Central Exchange Ltd
CXM	Centrex Mentals Ltd
CXO	Core Exploration Limited
CXU	
CXX	Cradle Resources Limited
CXZ	Connexion Media Limited
CY5	Cygnus Gold Limited
CYA	Century Australia Investments Ltd
CYB	Cybg Plc
CYBKOD	Cybg Plc
CYBKOE	Cybg Plc
CYBKOP	Cybg Plc
CYBKOQ	Cybg Plc
CYBKOR	Cybg Plc
CYC	Cyclopharm Ltd
CYG	Coventry Group Ltd
CYL	Catalyst Metals Ltd
CYP	Cynata Therapeutics Limited
CYQ	Cycliq Group Ltd
CZI	Cassini Resources Limited
CZL	Consolidated Zinc Limited
CZN	Corazon Mining Limited
CZR	Coziron Resources Ltd
CZZ	Capilano Honey Limited
D13	Department 13 International Ltd
D2O	Duxton Water Limited
DAF	Discovery Africa Limited
DAU	Dampier Gold Limited
DAV	Davenport Resources Limited
DBF	Duxton Broadacre Farms Limited
DCC	Digital Cc Limited
DCG	Decmil Group Limited
DCL	Data & Commerce
DCN	Dacian Gold Limited
DDD	3D Resources Ltd
DDDO	3d Resources Limited
DDR	Dicker Data Limited
DDT	DataDot Technology Ltd
DEG	De Grey Mining Ltd
DEGO	DEGO
DEM	De.mem Limited
DEV	Devex Resources Limited
DFM	Dongfang Modern Agriculture Holding Group Limited
DGH	Desane Group Holdings Ltd
DGO	Drummond Gold Ltd
DGR	D'Aguilar Gold Ltd
DGX	Diploma Group Ltd
DHG	Domain Holdings Australia Limited.
DHGKOB	Domain Holdings Australia Limited.
DHGKOP	Domain Holdings Australia Limited.
DHGKOQ	Domain Holdings Australia Limited.
DHR	Dark Horse Resources Limited
DIG	Digital Performance Group Ltd
DIV	DIV
DJW	Djerriwarth Investments Ltd
DJXKOC	DJXKOC
DJXKOD	Djia Mini E-cbot
DJXKOG	DJXKOG
DJXKOJ	DJXKOJ
DJXKOV	DJXKOV
DJXKOY	DJXKOY
DJXMOP	DJXMOP
DJXMOR	DJXMOR
DJXMOS	DJXMOS
DJXMOT	DJXMOT
DJXMOU	DJXMOU
DKM	Duketon Mining Limited
DLC	DLC
DLX	Duluxgroup Limited
DLXKOB	Duluxgroup Limited
DLXKOC	Duluxgroup Limited
DLXKOS	Duluxgroup Limited
DMA	Dynasty Metals Australia Ltd
DMC	Digimatic Group Limited
DME	Dome Gold Mines Limited
DMG	Dragon Gold Mountain Ltd
DMI	Dempsey Minerals Limited
DMIOA	Dempsey Minerals Limited
DMKT	DMKT
DMP	Domino's Pizza Australia NZ Ltd
DMPKOA	Dominos Pizza Enterprises Limited
DMPKOB	Dominos Pizza Enterprises Limited
DMPKOC	Dominos Pizza Enterprises Limited
DMPKOD	Dominos Pizza Enterprises Limited
DMPKOF	Dominos Pizza Enterprises Limited
DMPKOQ	Dominos Pizza Enterprises Limited
DMPKOT	Dominos Pizza Enterprises Limited
DMPKOU	Dominos Pizza Enterprises Limited
DN8	Dreamscape Networks Limited
DNA	Donaco International Limited
DNK	Danakali Limited
DOR	Doriemus Plc
DOW	Downer EDI Ltd
DOWKOB	Downer Edi Limited
DOWKOD	Downer Edi Limited
DOWKOE	Downer Edi Limited
DOWKOF	Downer Edi Limited
DOWKOQ	Downer Edi Limited
DOWKOT	Downer Edi Limited
DOWKOU	Downer Edi Limited
DRA	Dragon Mining NL
DRG	Draig Resources Limited
DRK	Drake Resources Ltd
DRM	Doray Minerals Limited
DRO	Droneshield Limited
DRUG	DRUG
DRX	Diatreme Resources Ltd
DSE	Dropsuite Limited
DSX	Decimal Software Limited
DTI	Dti Group Ltd
DTL	Data#3 Ltd
DTM	Dart Mining NL
DTMOA	Dart Mining Nl
DTR	Dateline Resources Limited
DTS	Dragontail Systems Limited
DTZ	Dotz Nano Limited
DUB	Dubber Corporation Limited
DUI	Diversified United Investment Ltd
DVL	Dorsavi Ltd
DVN	Devine Ltd
DW8	Dawine Ltd
DWS	DWS Advanced Business Solutions Ltd
DXB	Dimerix Limited
DXN	The Data Exchange Network Limited
DXS	Dexus Property Group
DXSKOA	Dexus Property Group
DXSKOB	Dexus Property Group
DXSKOP	Dexus Property Group
DXSKOQ	Dexus Property Group
DXSKOR	Dexus Property Group
DYL	Deep Yellow Ltd
DYLO	Deep Yellow Limited
E25	Element 25 Limited
E2E	Eon Nrg Limited
E2EO	Eon Nrg Limited
E2M	E2 Metals Limited
E88	Ensogo Limited
EAF	East Africa Resources Limited
EAI	Ellerston Asian Investment Limited
EAIO	Ellerston Asian Investments Limited
EAR	Echo Resources Ltd
EAS	Easton Investments Limited
EAX	Energy Action Limited
EBG	Eumundi Group Ltd
EBO	Ebos Group Limited
ECG	Ecargo Holdings Limited
ECT	Environmental Clean Technologies Limited.
ECTOC	Environmental Clean Technologies Limited.
ECX	Eclipx Group Limited
ED1	Evans Dixon Limited
EDC	Eildon Capital Limited
EDE	Eden Energy Ltd
EDEO	Eden Energy Ltd
EEG	Empire Energy Group Limited
EER	East Energy Resources Ltd
EEU	Betashares Euro Etf
EFE	Eastern Iron Ltd
EFF	Evans & Partners Australian Flagship Fund
EGA	Egan Street Resources Limited
EGD	Evans & Partners Global Disruption Fund
EGF	Ellerston Gems Fund
EGG	Enero Group Limited
EGH	Eureka Group Holdings Limited
EGI	eGlobal International
EGL	Environmental Group Ltd (The)
EGN	EGN
EGS	Eastern Goldfields Limited
EGY	Energy Technologies Limited
EHE	Estia Health Limited
EHEKOD	Estia Health Limited
EHEKOE	Estia Health Limited
EHEKOP	Estia Health Limited
EHEKOQ	Estia Health Limited
EHH	Eagle Health Holdings Limited
EHL	Emeco Holdings Ltd
EHX	Ehr Resources Limited
EIGA	EIGA
EINC	EINC
ELD	ELD
ELK	ELK Petroleum Ltd
ELO	Elmo Software Limited
ELS	Equity Long / Short Strategies Fund (the)
ELSO	Elsight Limited
ELT	Elementos Limited
ELX	Ellex Medical Lasers Ltd
EM1	Emerge Gaming Limited
EM1O	Emerge Gaming Limited
EM2	Eagle Mountain Mining Limited
EMB	Embelton Ltd
EME	Energy Metals Ltd
EMF	Emerging Markets Masters Fund
EMG	Emergent Resources Ltd
EMH	European Metals Holdings Limited
EMKT	EMKT
EML	Emerchants Limited
EMP	Emperor Mines Ltd
EMPOC	Emperor Energy Limited
EMR	Emerald Oil & Gas NL
EMU	EMU Nickel NL
EMUCA	Emu Nl
EN1	Engage:bdr Limited
EN1O	Engage:bdr Limited
ENA	Ensurance Ltd
ENB	Eneabba Gas Ltd
ENN	Elanor Investors Group
ENR	Encounter Resources Ltd
ENT	
ENX	Enegex Nl
EOL	Energy One Ltd
EOR	Enhanced Oil & Gas Recovery Limited
EOS	Electro Optic Systems Holdings Ltd
EPA	Ephraim Resources Limited
EPD	Empired Ltd
EPM	Eclipse Metals Limited.
EPW	Erm Power Limited
EQE	Equus Mining Limited
EQT	Equity Trustees Ltd
EQX	Eqitx Ltd
ERA	Energy Resources of Australia Ltd
ERF	Elanor Retail Property Fund
ERL	Empire Resources Ltd
ERM	Emmerson Resources Ltd
ESE	Esense-lab Ltd
ESH	Esports Mogul Asia Pacific Limited
ESHO	Esports Mogul Asia Pacific Limited
ESI	Environmental Solutions Internationl
ESIOC	Environmental Clean Technologies Limited
ESK	Etherstack Plc
ESM	Esperance Minerals Nl
ESR	Estrella Resources Limited
ESV	eServGlobal Ltd
ETE	Entek Energy Ltd
ETF	ETF
ETPMAG	ETFS Physical Silver
ETPMPD	ETP
ETPMPM	ETFS Physical PM Basket
ETPMPT	ETP
EUC	European Cobalt Ltd
EUR	Euraust Ltd
EUZ	Europa Metals Ltd
EVE	Energy Ventures Ltd
EVM	EnviroMission Ltd
EVN	Evolution Mining Limited
EVNKOA	Evolution Mining Limited
EVNKOB	Evolution Mining Limited
EVNKOC	Evolution Mining Limited
EVNKOS	Evolution Mining Limited
EVNKOT	Evolution Mining Limited
EVO	Evolve Education Group Limited
EVS	Envirosuite Limited
EVT	Event Hospitality And Entertainment Ltd
EVZ	Envirozel Ltd
EWC	Energy World Corporation Ltd
EX20	EX20
EXG	Excelsior Gold Limited
EXL	Excel Coal Ltd
EXO	Ennox Group Ltd
EXP	Experience Co Limited
EXR	Elixir Petroleum Ltd
EXU	Explaurum Limited
EZL	Euroz Ltd
FAIR	FAIR
FAR	First Australian Resources Ltd
FAU	First Au Limited
FAUO	First Au Limited
FBR	Fastbrick Robotics Ltd
FBU	Fletcher Building Ltd
FBUKOA	Fletcher Building Limited
FBUKOP	Fletcher Building Limited
FBUKOQ	Fletcher Building Limited
FCC	First Cobalt Corp.
FCG	Frontier Capital Group Limited
FCT	Firstwave Cloud Technology Limited
FDM	Freedom Oil And Gas Ltd
FDV	Frontier Digital Ventures Limited
FDX	Frontier Diamonds Ltd
FE8	Faster Enterprises Ltd
FEI	Fe Investments Group Limited
FEL	Fe Limited
FET	Folkestone Education Trust
FFC	Farmaforce Limited
FFG	Fatfish Internet Group Ltd
FFI	FFI Holdings Ltd
FGF	First Growth Funds Limited
FGG	Future Generation Global Investment Company Limited
FGO	Flamingo Ai Limited
FGR	First Graphite Limited
FGROC	First Graphite Limited
FGX	Future Generation Investment Fund Limited
FHS	Freehill Mining Limited.
FID	Fiducian Group Limited
FIG	Freedom Insurance Group Ltd
FIN	Aii S&p/asx 200 Financials
FLC	Fluence Corporation Limited
FLK	Folkestone Ltd
FLN	Freelancer Limited
FLOT	FLOT
FLT	Flight Centre Ltd
FLTKOB	Flight Centre Travel Group Limited
FLTKOC	Flight Centre Travel Group Limited
FLTKOP	Flight Centre Travel Group Limited
FLTKOR	Flight Centre Travel Group Limited
FMG	Fortescue Metals Group Ltd
FMGBOA	Fortescue Metals Group Ltd
FMGBOB	Fortescue Metals Group Ltd
FMGBOC	Fortescue Metals Group Ltd
FMGBOF	Fortescue Metals Group Ltd
FMGBOG	Fortescue Metals Group Ltd
FMGBON	Fortescue Metals Group Ltd
FMGBOQ	Fortescue Metals Group Ltd
FMGBOR	Fortescue Metals Group Ltd
FMGBOU	Fortescue Metals Group Ltd
FMGKOB	Fortescue Metals Group Ltd
FMGKOH	Fortescue Metals Group Ltd
FMGKOI	Fortescue Metals Group Ltd
FMGKOK	Fortescue Metals Group Ltd
FMGKOL	Fortescue Metals Group Ltd
FMGKOQ	Fortescue Metals Group Ltd
FMGKOR	Fortescue Metals Group Ltd
FMGKOT	Fortescue Metals Group Ltd
FMGKOV	Fortescue Metals Group Ltd
FMGMOD	Fortescue Metals Group Ltd
FMGMOQ	Fortescue Metals Group Ltd
FMGMOT	Fortescue Metals Group Ltd
FMGMOU	Fortescue Metals Group Ltd
FMGMOW	Fortescue Metals Group Ltd
FMGMOX	Fortescue Metals Group Ltd
FML	Focus Minerals Ltd
FMS	Flinders Mines Ltd
FND	Finders Resources Ltd
FNP	Freedom Nutritional Products Ltd
FNT	Frontier Resources Ltd
FOD	The Food Revolution Group Limited
FOR	Forager Australian Shares Fund
FPC	Fat Prophets Global Contrarian Fund Ltd
FPH	Fisher & Paykel Healthcare Corp Ltd
FPL	Fremont Petroleum Corporation Limited
FPLOA	Fremont Petroleum Corporation Limited
FPP	Fat Prophets Global Property Fund
FRC	Forte Consolidated Limited
FRI	Finbar International Ltd
FRM	Farm Pride Foods Ltd
FRN	Fraser Range Metals Group Ltd
FRX	Flexiroam Limited
FSA	FSA Group Ltd
FSF	Fonterra Shareholders Fund
FSG	Field Solutions Holdings Limited
FSI	Flagship Investments Limited
FTC	Fintech Chain Limited
FTT	Factor Therapeutics Limited
FTZ	Fertoz Limited
FUEL	FUEL
FUN	Funtastic Ltd
FWD	Fleetwood Corporation Ltd
FXEKOC	FXEKOC
FXEKOD	FXEKOD
FXEKOG	FXEKOG
FXEKOQ	Currency Warrant Aud/eur
FXEKOS	Currency Warrant Aud/eur
FXJ	Fairfax (John) Holdings Ltd
FXJKOB	Fairfax Media Limited
FXJKOC	Fairfax Media Limited
FXJKOD	Fairfax Media Limited
FXJKOF	Fairfax Media Limited
FXJKOQ	Fairfax Media Limited
FXJKOR	Fairfax Media Limited
FXJKOS	Fairfax Media Limited
FXJKOT	Fairfax Media Limited
FXL	Flexigroup Ltd
FXLKOB	Flexigroup Limited
FXLKOD	Flexigroup Limited
FXLKOE	Flexigroup Limited
FXLKOF	Flexigroup Limited
FXPKOA	FXPKOA
FXPKOB	FXPKOB
FXPKOC	FXPKOC
FXPKOD	FXPKOD
FXPKOF	FXPKOF
FXPKOQ	Currency Warrant Aud/gbp
FXPKOT	FXPKOT
FXPKOU	FXPKOU
FXPKOV	FXPKOV
FXUKOA	Currency Warrant Aus/usd.
FXUKOB	Currency Warrant Aus/usd.
FXUKOE	Currency Warrant Aus/usd.
FXUKOH	FXUKOH
FXUKOK	FXUKOK
FXUKOL	FXUKOL
FXUKOM	FXUKOM
FXUKON	FXUKON
FXUKOO	FXUKOO
FXUKOQ	Currency Warrant Aus/usd.
FXUKOR	Currency Warrant Aus/usd.
FXUKOU	Currency Warrant Aus/usd.
FXUKOV	Currency Warrant Aus/usd.
FXUKOW	Currency Warrant Aus/usd.
FXUKOX	Currency Warrant Aus/usd.
FXUKOY	Currency Warrant Aus/usd.
FXUKOZ	Currency Warrant Aus/usd.
FXUMOQ	FXUMOQ
FXUMOT	FXUMOT
FXUMOX	FXUMOX
FXUQOP	FXUQOP
FXYKOA	FXYKOA
FXYKOB	Currency Warrant Aud/jpy
FXYKOC	FXYKOC
FXYKOR	FXYKOR
FXYKOS	FXYKOS
FXYKOU	FXYKOU
FXYKOY	FXYKOY
FXZKOA	FXZKOA
FXZKOB	FXZKOB
FXZKOD	FXZKOD
FXZKOE	FXZKOE
FXZKOP	Currency Warrant Aud/nzd
FXZKOQ	FXZKOQ
FXZKOS	FXZKOS
FYA	Fortune Asia Group Ltd
FYI	FYI
FZO	Family Zone Cyber Safety Limited
FZR	Fitzroy River Corporation Ltd
G1A	Galena Mining Limited
G88	Golden Mile Resources Ltd
GAL	Galicia Energy Corporation Ltd
GAP	Gale Pacific Ltd
GAS	GasNet Australia Group
GBA	Grandbridge Ltd
GBE	Globe Uranium Ltd
GBG	Gindalbie Metals Ltd
GBI	Genera Biosystems Ltd
GBM	Greater Bendigo Mines Ltd
GBP	Global Petroleum Ltd
GBR	G Retail Ltd
GBT	GBST Holdings Ltd
GBZ	GBM Resources Ltd
GBZOA	Gbm Resources Limited
GC1	Glennon Small Companies Limited
GCI	Gryphon Capital Income Trust
GCM	Garda Capital Group
GCN	GoConnect Ltd
GCR	Golden Cross Resources Ltd
GCS	Global Construction Services Ltd
GCY	Gascoyne Resources Limited
GDF	Garda Diversified Property Fund
GDG	Generation Development Group Limited
GDI	Gdi Property Group
GDX	GDX
GDXKOA	GDXKOA
GEAR	GEAR
GED	Golden Deeps Ltd
GEM	G8 Education Limited
GEMBOA	G8 Education Limited
GEMBON	G8 Education Limited
GEMKOA	G8 Education Limited
GEMKOC	G8 Education Limited
GEMKOP	G8 Education Limited
GES	Genesis Resources Limited
GEV	Global Energy Ventures Ltd
GFI	Global Fortune Investment Limited
GFL	Global Masters Fund Ltd
GFY	Godfreys Group Limited
GGE	Grand Gulf Energy Ltd
GGG	Gold Company Ltd
GGGOB	Greenland Minerals And Energy Limited
GGX	Gas2Grid Ltd
GID	Gi Dynamics Inc
GLA	Gladiator Resources Ltd
GLB	Globe International Ltd
GLE	GLG Corp Ltd
GLH	Global Health Ltd
GLIN	GLIN
GLL	Galilee Energy Limited
GMA	Genworth Mortgage Insurance Australia Limited
GMAKOA	Genworth Mortgage Insurance Australia Limited
GMAKOQ	Genworth Mortgage Insurance Australia Limited
GMAKOR	Genworth Mortgage Insurance Australia Limited
GMC	Gulf Minerals Corporation Ltd
GMCO	Gulf Manganese Corporation Limited
GMD	Genesis Minerals Ltd
GME	GME Resources Ltd
GMG	Goodman Group
GMGBOT	Goodman Group
GMGKOF	Goodman Group
GMGKOP	Goodman Group
GMGKOQ	Goodman Group
GML	Gateway Mining NL
GMN	Gold Mountain Limited
GMR	Golden Rim Resoures Ltd
GMRO	Golden Rim Resources Ltd
GMV	G Medical Innovations Holdings Limited
GMY	Goldfields Money Limited
GNC	GrainCorp Ltd
GNCKOB	Graincorp Limited
GNCKOC	Graincorp Limited
GNCKOE	Graincorp Limited
GNCKOF	Graincorp Limited
GNE	Genesis Energy Limited
GNG	Gr Engineering Services Limited
GNX	Genex Power Limited
GO2	The Go2 People Ltd
GOE	Go Energy Group Limited
GOLD	Gold Bullion Ltd
GOO	Gooroo Ventures Limited
GOR	Gold Road Resources Limited
GOVT	GOVT
GOW	Gowing Bros Ltd
GOZ	Growthpoint Properties Australia
GPP	Greenpower Energy Ltd
GPPO	Greenpower Energy Limited
GPPOA	Greenpower Energy Limited
GPR	Geopacific Resources NL
GPS	Gps Alliance Holdings Limited
GPT	General Property Trust
GPTKOB	Gpt Group
GPTKOC	Gpt Group
GPTKOD	Gpt Group
GPTKOP	Gpt Group
GPTKOR	Gpt Group
GPTKOS	Gpt Group
GPX	Graphex Mining Limited
GRB	Gage Road Brewing Co Ltd
GRR	Grange Resources Ltd
GRV	Greenvale Mining NL
GSBG20	Australian Government Treasury Bonds
GSBG23	Australian Government Treasury Bonds
GSBG24	Australian Government Treasury Bonds
GSBG25	Australian Government Treasury Bonds
GSBG26	Australian Government Treasury Bonds
GSBG27	Australian Government Treasury Bonds
GSBG29	Australian Government Treasury Bonds
GSBG33	Australian Government Treasury Bonds
GSBG37	Australian Government Treasury Bonds
GSBK35	Australian Government Treasury Bonds
GSBK39	Australian Government Treasury Bonds
GSBM22	Australian Government Treasury Bonds
GSBU20	Australian Government Treasury Bonds
GSBU22	GSBU22
GSBU27	Australian Government Treasury Bonds
GSBU28	Australian Government Treasury Bonds
GSBU29	GSBU29
GSC	Global Geoscience Ltd
GSIC22	Australian Government Treasury Indexed Bonds
GSIO20	Australian Government Treasury Indexed Bonds
GSIO35	Australian Government Treasury Indexed Bonds
GSIO40	Australian Government Treasury Indexed Bonds
GSIQ25	Australian Government Treasury Indexed Bonds
GSIQ30	Australian Government Treasury Indexed Bonds
GSIU18	Australian Government Treasury Indexed Bonds
GSIU27	Australian Government Treasury Indexed Bonds
GSL	Greatcell Solar Limited
GSN	Great Southern Mining Limited
GSS	Genetic Signatures Limited
GSW	Getswift Limited
GTE	Great Western Exploration Ltd
GTG	Genetic Technologies Ltd
GTK	Gentrack Group Limited
GTN	GTN Resources Ltd
GTR	GTI Resources Ltd
GTY	Gateway Lifestyle Group
GUD	GUD Holdings Ltd
GUL	Gullewa Ltd
GVF	Global Value Fund Limited
GWA	Gwa Group Limited.
GWAKOP	Gwa Group Limited.
GWR	Golden West Resources Ltd
GXL	Greenross Ltd
GXY	Galaxy Resources Ltd
GXYKOC	Galaxy Resources Limited
GXYKOE	Galaxy Resources Limited
GXYKOF	Galaxy Resources Limited
GZL	Gazal Corporation Ltd
HACK	HACK
HAR	Haranga Resources Limited
HAS	Hastings Rare Metals Ltd
HAV	Havilah Resources NL
HAVOC	Havilah Resources Limited
HAW	Hawthorn Resources Ltd
HCH	Hot Chili Limited
HCO	Hylea Metals Limited
HCT	Holista Colltech Limited
HDY	Hardey Resources Limited
HDYOC	Hardey Resources Limited
HE8	Helios Energy Ltd
HE8OA	Helios Energy Ltd
HEG	Hill End Gold Ltd
HEGOC	Hill End Gold Limited
HEUR	HEUR
HFR	Highfield Resources Limited
HGL	Hudson Investment Group Ltd
HGM	High Grade Metals Limited
HGO	Hillgrove Resources Ltd
HHM	Hampton Hill Mining NL
HHY	Hastings High Yield Fund
HIG	Highlands Pacific Ltd (PNG)
HIL	Hills Industries Ltd
HIP	Hyperion Flagship Investments Ltd
HIPOA	Hipo Resources Limited
HIT	Hitech Group Australia Ltd
HJPN	HJPN
HLO	Helloworld Limited
HLX	Helix Resources Ltd
HML	Hamill Resources
HMLO	
HMO	Hearmeout Limited
HMX	Hammer Metals Limited
HNG	HGL Ltd
HNR	Hannans Reward NL
HOG	Hawkley Oil And Gas Limited
HOM	Homeloans Ltd
HOR	Horseshoe Metals Limited
HOT	Hotcopper Holdings Limited
HPI	Hotel Property Investments
HPR	High Peak Royalties Limited
HRL	Hot Rock
HRN	Horizon Gold Limited
HRR	Heron Resources Ltd
HSN	Hansen Technologies Ltd
HSO	Healthscope Limited.
HSOKOA	Healthscope Limited.
HSOKOD	Healthscope Limited.
HSOKOQ	Healthscope Limited.
HSXKOB	HSXKOB
HSXKOC	HSXKOC
HSXKOE	HSXKOE
HSXKOQ	HSXKOQ
HSXKOT	HSXKOT
HSXKOX	HSXKOX
HSXMOY	HSXMOY
HT1	Ht&e Limited
HT8	Harris Technology Group Limited
HTA	Hutchison Telecommunications (Aust)
HUB	Hub24 Limited
HUO	Huon Aquaculture Group Limited
HVN	Harvey Norman Holdings Ltd
HVNBON	Harvey Norman Holdings Limited
HVNBOR	Harvey Norman Holdings Limited
HVNKOA	Harvey Norman Holdings Limited
HVNKOC	Harvey Norman Holdings Limited
HVNKOE	Harvey Norman Holdings Limited
HVNKOP	Harvey Norman Holdings Limited
HVNKOR	Harvey Norman Holdings Limited
HVNKOW	Harvey Norman Holdings Limited
HVST	HVST
HWK	Hawkstone Mining Limited
HXG	Hexagon Resources Limited
HZN	Horizon Oil Ltd
HZR	Hazer Group Limited
HZRO	Hazer Group Limited
IAA	
IAB	Inabox Group Limited
IAF	Ishares Ubs Composite Bond Index Fund
IAG	Insurance Australia Group Ltd
IAGKOA	Insurance Australia Group Limited
IAGKOB	Insurance Australia Group Limited
IAGKOD	Insurance Australia Group Limited
IAGKOQ	Insurance Australia Group Limited
IAGKOR	Insurance Australia Group Limited
IAGKOT	Insurance Australia Group Limited
IAGPD	Insurance Australia Group Limited
IAM	Intiger Group Limited
IANG	IANG
IAU	Intrepid Mines Ltd
IB8	Ibosses Corporation Limited
IBC	Ironbark Capital Ltd
IBG	Ironbark Gold Ltd
IBN	Ibuynew Group Limited
IBX	Imagion Biosystems Limited
ICG	Inca Minerals Limited
ICI	Icandy Interactive Limited
ICIO	Icandy Interactive Limited
ICN	Icon Energy Ltd
ICQ	Icar Asia Limited
ICS	ICSGlobal Ltd
ICT	Incitec
ICTOB	Icollege Limited
ICU	Isentric Limited
IDA	Indiana Resources Limited
IDO	Indo Mines Ltd
IDR	Industria Reit Fund
IDT	Institute of Drug Technology Aust
IDX	Indexshares Fund The
IDZ	Indoor Skydive Australia Group Limited
IEC	Intra Energy Corporation Limited
IEL	Idp Education Limited
IEM	iShares MSCI Emerging Markets
IEQ	International Equities Corp Ltd
IEU	iShares S&P Europe 350
IFL	IOOF Holdings Ltd
IFLKOC	Ioof Holdings Limited
IFLKOP	Ioof Holdings Limited
IFLKOQ	Ioof Holdings Limited
IFM	Infomedia Ltd
IFN	IFN
IFNKOA	Infigen Energy
IFRA	IFRA
IFT	Infratil Limited.
IGB	Ishares Ubs Treasury Index Fund
IGE	Integrated Green Energy Solutions Ltd
IGL	International Goldfields Ltd
IGO	Independence Group NL
IGOKOA	Independence Group Nl
IGOKOB	Independence Group Nl
IGOKOC	Independence Group Nl
IGOKOD	Independence Group Nl
IGOKOQ	Independence Group Nl
IGOKOR	Independence Group Nl
IGOKOT	Independence Group Nl
IGS	International Goldfields Limited...
IHCB	IHCB
IHD	Ishares S&p/asx High Dividend
IHEB	IHEB
IHL	Impression Healthcare Limited
IHLOA	Impression Healthcare Limited
IHLOB	Impression Healthcare Limited
IHOO	IHOO
IHR	Intellihr Holdings Limited
IHWL	IHWL
IIL	Innate Immunotherapeutics Limited
IJH	iShares S&P Midcap 400
IJP	iShares MSCI Japan
IJR	iShares S&P Smallcap 600
IKE	Ikegps Group Limited
IKO	iShares MSCI South Korea
IKW	Ikwezi Mining Limited
ILB	Ishares Ubs Government Inflation Index Fund
ILC	Ishares S&p/asx 20
ILU	Iluka Resources Ltd
ILUKOA	Iluka Resources Limited
ILUKOC	Iluka Resources Limited
ILUKOD	Iluka Resources Limited
ILUKOE	Iluka Resources Limited
ILUKOF	Iluka Resources Limited
ILUKOP	Iluka Resources Limited
ILUKOQ	Iluka Resources Limited
ILUKOR	Iluka Resources Limited
ILUKOS	Iluka Resources Limited
ILUKOY	Iluka Resources Limited
IMA	Image Resources NL
IMC	
IMCOB	Immuron Limited
IMD	Imdex Ltd
IMF	IMF (Australia) Ltd
IMFHA	Bentham Imf Limited
IMM	Immutep Limited
IMS	Impelus Limited
IMU	Imugene Ltd
IMUOA	Imugene Limited
IMUOB	Imugene Limited
INA	Ingenia Communities Group
IND	Indus Energy Nl
INF	Infosentials
ING	Inghams Group Limited
INIF	INIF
INK	Indago Energy Limited
INM	Iron Mountain Incorporated
INP	Innamincka Petroleum Ltd
INV	InvestorInfo Ltd
IOD	Iodm Limited
IOF	ING Office Fund
IOO	iShares S&P Global 100
IOR	Ior Group Limited
IOT	Iot Group Limited
IOTO	Iot Group Limited
IOZ	Ishares Msci Australia 200
IP1	Integrated Payment Technologies Limited
IPB	Ipb Petroleum Limited
IPC	Imperial Pacific Limited
IPD	Impedimed Ltd
IPE	ING Private Equity Access Ltd
IPH	Ipoh
IPHKOA	Iph Limited
IPHKOB	Iph Limited
IPHKOD	Iph Limited
IPL	Incitec Pivot Ltd
IPLKOA	Incitec Pivot Limited
IPLKOC	Incitec Pivot Limited
IPLKOD	Incitec Pivot Limited
IPLKOE	Incitec Pivot Limited
IPLKOG	Incitec Pivot Limited
IPLKOP	Incitec Pivot Limited
IPLKOQ	Incitec Pivot Limited
IPLKOS	Incitec Pivot Limited
IPLKOT	Incitec Pivot Limited
IPLKOU	Incitec Pivot Limited
IPT	Impact Minerals Ltd
IPTOA	Impact Minerals Limited
IQ3	Iq3corp Limited
IRC	Intermin Resources Ltd
IRCOA	Intermin Resources Limited
IRD	Iron Road Ltd
IRE	IRESS Market Technology Ltd
IREKOA	Iress Limited
IREKOP	Iress Limited
IREKOQ	Iress Limited
IRI	Integrated Research Ltd
IRL	India Resources Ltd
IS3	I Synergy Group Limited
ISD	Isentia Group Limited
ISEC	ISEC
ISO	Ishares S&p/asx Small Ordinaries
ISU	Iselect Limited.
ISX	Isignthis Ltd
ITD	ITL Ltd
ITW	iShares MSCI Taiwan
IVC	InvoCare Ltd
IVCKOA	Invocare Limited
IVCKOC	Invocare Limited
IVCKOE	Invocare Limited
IVCKOR	Invocare Limited
IVCKOT	Invocare Limited
IVE	iShares MSCI Eafe
IVO	Invigor Group Limited
IVQ	Invitrocue Limited
IVR	IVR
IVROA	Investigator Resources Ltd
IVT	Inventis Ltd
IVV	iShares S&P 500
IVX	Invion Limited
IVZ	Invictus Energy Ltd
IXI	
IXJ	IXJ
IXU	Ixup Limited
IZZ	iShares FTSE Xinhua China
JAL	Jameson Resources Ltd
JAN	Janison Education Group Limited
JAT	
JAY	Jayride Group Limited
JBH	JB Hi-Fi Ltd
JBHKOB	Jb Hi-fi Limited
JBHKOD	Jb Hi-fi Limited
JCI	Jc International Group Limited
JCS	Jcurve Solutions Ltd
JDR	Jadar Lithium Limited
JHC	Japara Healthcare Limited
JHCKOA	Japara Healthcare Limited
JHCKOB	Japara Healthcare Limited
JHCKOC	Japara Healthcare Limited
JHG	Janus Henderson Group Plc
JHGBON	Janus Henderson Group Plc
JHGKOA	Janus Henderson Group Plc
JHGKOD	Janus Henderson Group Plc
JHGKOQ	Janus Henderson Group Plc
JHGKOR	Janus Henderson Group Plc
JHL	Jayex Healthcare Limited
JHX	James Hardie Industries NV (CUFS)
JHXKOB	James Hardie Industries Plc
JHXKOD	James Hardie Industries Plc
JHXKOE	James Hardie Industries Plc
JHXKOP	James Hardie Industries Se
JHXKOR	James Hardie Industries Se
JHXKOT	James Hardie Industries Plc
JIN	JIN
JIP	Jack-in Group Limited
JJF	Jiajiafu Modern Agriculture Limited
JKA	Jacka Resources Limited
JKAOC	Jacka Resources Limited
JKL	Justkapital Litigation Partners Limited
JLG	Johns Lyng Group Limited
JMS	Jupiter Mines Ltd
JPR	Jupiter Energy Ltd
JRL	Jindalee Resources Ltd
JRV	Jervois Mining Ltd
JVG	JV Global Ltd
JYC	Joyce Corporation Ltd
K2F	K2fly Limited
K2FOA	K2fly Limited
KAI	Kairos Minerals Limited
KAM	K2 Asset Management Holdings Ltd
KAR	Karoon Gas Australia Ltd
KARKOR	Karoon Gas Australia Limited
KARKOU	Karoon Gas Australia Limited
KARKOV	Karoon Gas Australia Limited
KAS	Kasbah Resources Ltd
KAT	Katana Capital Ltd
KBC	Keybridge Capital Ltd
KBCPA	Keybridge Capital Limited
KBL	Kimberley Metals Limited
KBLGA	Kimberley Metals Limited
KBLO	Kbl Mining Limited
KCN	Kingsgate Consolidated Ltd
KDR	Kidman Resources Limited
KEY	Key Petroleum Ltd
KFE	Kogi Iron Limited
KGD	Kula Gold Limited
KGL	Kentor Gold Ltd
KGM	Kalnorth Gold Mines Limited
KGN	Kogan.com Ltd
KII	KII
KIK	Kairiki Energy Ltd
KIN	Kin Mining Nl
KIS	King Island Scheelite Ltd
KISRA	King Island Scheelite Limited
KKL	Kollakorn Corporation Limited
KKO	Kinetiko Energy Ltd
KKT	Konekt Ltd
KLA	Koala Corporation Australia
KLH	Kalia Limited
KLL	Kalium Lakes Limited
KLO	Kingsland Global Ltd
KLR	Kaili Resources Limited
KMD	Kathmandu Holdings Limited
KME	Kip McGrath Education Centres
KMT	Kopore Metals Limited
KNH	Koon Holdings Ltd
KNL	Kagera Nickel Limited
KNM	Kneomedia Limited
KNO	Knosys Limited
KOR	Korab Resources Ltd
KOV	Korvest Ltd
KP2	Kore Potash Plc
KPC	Kazakhstan Potash Corporation Limited
KPG	Kelly Partners Group Holdings Limited
KPL	Kina Petroleum Limited
KPO	Kalina Power Limited
KPT	Kangaroo Island Plantation Timbers Ltd
KRC	King River Copper Limited
KRCOB	King River Copper Limited
KRL	Kintore Resources Limited
KRM	Kingsrose Mining Ltd
KRS	Kresta Holdings Ltd
KRX	Koppar Resources Limited
KRXO	Koppar Resources Limited
KSC	K&S Corporation Ltd
KSL	Kina Securities Limited
KSM	Kingstream Steel
KSN	Kingston Resources Limited
KTA	Krakatoa Resources Limited
KTAOB	Krakatoa Resources Limited
KTD	Keytone Dairy Corporation Limited
KTE	K2 Energy Ltd
KYK	Kyckr Limited
KZA	Kazia Therapeutics Limited
KZAO	Kazia Therapeutics Limited
KZR	Kalamazoo Resources Limited
LAA	Latam Autos Limited
LAM	Laramide Resources Ltd
LAU	Lindsay Australia Ltd
LBL	Laserbond Ltd
LBT	Labtech Systems Ltd
LCA	Litigation Capital Management Limited
LCD	Latitude Consolidated Limited
LCE	London City Equities Ltd
LCK	Leigh Creek Energy Limited
LCM	Logicamms Ltd
LCT	Living Cell Technologies Ltd
LCY	Legacy Iron Ore Ltd
LEG	Legend Mining Ltd
LEP	ALE Property Group
LER	LER
LEX	Lefroy Exploration Limited
LGD	Legend Corporation Ltd
LGO	Longreach Oil Ltd
LGR	Lanka Graphite Limited
LHB	Lionhub Group Limited
LHBO	Lionhub Group Limited
LHM	Land & Homes Group Limited
LHMO	Land & Homes Group Limited
LI3	Lithium Consolidated Mineral Exploration Limited
LIC	Lifestyles Communities Ltd
LIN	Lindian Resources Ltd
LINO	Lindian Resources Ltd
LIO	Lion Energy Ltd
LIT	Lithium Australia Nl
LITCE	Lithium Australia Nl
LKE	Lake Resources NL
LKEO	Lake Resources N.l.
LKEOA	Lake Resources N.l.
LKO	Lakes Oil NL
LLC	Lend Lease Corporation Ltd
LLCBON	Lendlease Group
LLCKOA	Lend Lease Group
LLCKOC	Lend Lease Group
LLCKOD	Lend Lease Group
LLCKOF	Lend Lease Group
LLCKOP	Lend Lease Group
LLCKOT	Lend Lease Group
LLCKOV	Lend Lease Group
LLO	Lion One Metals Limited
LMG	Latrobe Magnesium Ltd
LML	Lincoln Minerals Ltd
LMW	LandMark White Ltd
LNG	Liquefied Natural Gas Ltd
LNGKOR	Liquefied Natural Gas Limited
LNGKOS	Liquefied Natural Gas Limited
LNK	Link Administration Holdings Limited
LNKBON	Link Administration Holdings Limited
LNU	Linius Technologies Limited
LNUOA	Linius Technologies Limited
LNY	Laneway Resources Ltd
LOM	Lonrho Mining Ltd
LON	Longtable Group Limited
LOV	Lovisa Holdings Limited
LPD	Lepidico Ltd
LPE	Locality Planning Energy Holdings Ltd
LPI	Lithium Power International Limited
LPIOA	Lithium Power International Limited
LRM	Lustrum Minerals Ltd
LRS	Latin Resources Limited
LRSOB	Latin Resources Limited
LRT	Lowell Resources Fund
LSA	Lachlan Star Ltd
LSF	L1 Long Short Fund Limited
LSH	Lifespot Health Ltd
LSR	Lodestar Minerals Ltd
LSROA	Lodestar Minerals Limited
LSX	Lion Selection Group Limited.
LSXOA	Lion Selection Group Limited.
LTN	Lantern Hotel Group
LTR	Liontown Resources Ltd
LVE	Love Group Global Ltd
LVH	Livehire Limited
LVT	Livetiles Limited
LYC	Lynas Corporation Ltd
LYCKOB	Lynas Corporation Limited
LYCKOC	Lynas Corporation Limited
LYCKOP	Lynas Corporation Limited
LYCKOQ	Lynas Corporation Limited
LYCKOS	Lynas Corporation Limited
LYCKOT	Lynas Corporation Limited
LYL	Lycopodium Ltd
M7T	Mach7 Technologies Limited
MA1	Monash Absolute Investment Company Limited
MAG	Magellan Petroleum Australia Ltd
MAGO	Magmatic Resources Limited
MAH	Macmahon Holdings Ltd
MAI	Mainstreambpo Limited
MAM	Aii S&p/asx 300 Metals & Mining
MAQ	Macquarie Telecom Group Ltd
MAR	Malachite Resources NL
MAS	Mesa Minerals Limited
MAT	Matine Ltd t/over
MAU	Magnetic Resources NL
MAUCA	Magnetic Resources Nl
MAX	Milliniums Alternatives Fund
MAY	Mayne Group Ltd
MBK	Metal Bank Limited
MBLHB	MBLHB
MBLPA	
MBM	Mobecom Limited
MBO	Mobilarm Limited
MBT	Mission Biofuels Ltd
MCA	Medica Holdings
MCE	Matrix Composites & Engineering Limited
MCH	Murchison Holdings Ltd
MCM	Mc Mining Limited
MCP	McPhersons Ltd
MCR	Mincor Resources NL
MCT	Metalicity Limited
MCX	Mariner Corporation Limited
MCY	Mighty River Power Limited.
MDC	McConnell Dowell Corporation
MDD	Mandalong Resources Limited
MDI	Middle Island Resources Limited
MDL	Mineral Deposits Ltd
MDR	Medadvisor Limited
MDX	Mindax Ltd
MEA	Media Corporation Australia
MEB	Medibio Limited
MEC	Morphic Ethical Equities Fund Limited
MECO	Morphic Ethical Equities Fund Limited
MED	Merlin Diamonds Limited
MEDOB	Merlin Diamonds Limited
MEI	Meteoric Resources NL
MEL	Metgasco Ltd
MEM	Memphasys Limited.
MEP	Minotaur Exploration Ltd
MEU	Maramota Energy Ltd
MEY	Marenica Energy Ltd
MEZ	Meridian Energy Limited
MFD	Mayfield Childcare Limited
MFF	Magellan Flagship Fund Ltd
MFG	Magellan Financial Group
MFGKOA	Magellan Financial Group Limited
MFGKOC	Magellan Financial Group Limited
MFGKOP	Magellan Financial Group Limited
MFGKOQ	Magellan Financial Group Limited
MFGKOR	Magellan Financial Group Limited
MGC	Mg Unit Trust
MGE	Magnetic Minerals
MGG	Magellan Global Trust
MGGBOA	Magellan Global Trust
MGGBOF	Magellan Global Trust
MGL	Magontec Limited
MGP	Managed Accounts Holdings Limited
MGR	Mirvac Group
MGRKOC	Mirvac Group
MGRKOD	Mirvac Group
MGRKOP	Mirvac Group
MGRKOQ	Mirvac Group
MGRKOS	Mirvac Group
MGT	Magnetite Mines Limited.
MGTOC	Magnetite Mines Limited.
MGU	Magnum Gold NL
MGV	Musgrave Minerals Limited
MGX	Mount Gibson Iron Ltd
MGXKOJ	Mount Gibson Iron Limited
MGXKON	Mount Gibson Iron Limited
MGXKOR	Mount Gibson Iron Limited
MGZ	Medigard Ltd
MHC	Manhattan Corporation Limited
MHD	Millennium Limited
MHG	MHG
MHI	Merchant House International Ltd
MHJ	Michael Hill International Limited
MICH	MICH
MIG	Macquarie Infrastructure Group
MIH	Mnc Media Investment Ltd
MIL	Magnesium International Ltd
MIN	Mineral Resources Ltd
MINKOB	Mineral Resources Limited
MINKOQ	Mineral Resources Limited
MINKOV	Mineral Resources Limited
MINKOW	Mineral Resources Limited
MIR	Mirrabooka Investments Ltd
MJC	Mejority Capital Limited
MKB	MKB
MKG	Mako Gold Limited
MKGO	Mako Gold Limited
MLD	Maca Limited
MLM	Metallica Minerals Ltd
MLMOA	Metallica Minerals Limited
MLS	Metals Australia Ltd
MLSO	Metals Australia Ltd
MLSOA	Metals Australia Ltd
MLT	Milton Corporation Ltd
MLX	Metals X Ltd
MMG	Macquarie Media Group
MMI	Metro Mining Limited
MMJ	Mmj Phytotech Limited
MML	Medusa Mining Ltd
MMLKOQ	Medusa Mining Limited
MMLKOV	Medusa Mining Limited
MMM	Marley Spoon Ag
MMR	Mec Resources Ltd
MMS	McMillan Shakespeare Ltd
MMSKOA	Mcmillan Shakespeare Limited
MMSKOC	Mcmillan Shakespeare Limited
MMSKOD	Mcmillan Shakespeare Limited
MMSKOE	Mcmillan Shakespeare Limited
MNB	Minbos Resources Limited
MNC	Metminco Ltd
MNCOA	Metminco Limited
MND	Monadelphous Group Ltd
MNDKOA	Monadelphous Group Limited
MNDKOD	Monadelphous Group Limited
MNDKOE	Monadelphous Group Limited
MNDKOP	Monadelphous Group Limited
MNDKOQ	Monadelphous Group Limited
MNDKOT	Monadelphous Group Limited
MNF	My Net Fone Ltd
MNS	Milnes Holdings
MNW	Mint Wireless Ltd
MNY	Money3 Corporation Ltd
MOAT	MOAT
MOB	Mobile Innovations Ltd
MOC	Mortgage Choice Ltd
MOD	Medical Corporation Australasia Ltd
MOE	Moto Goldmines Ltd
MOGL	MOGL
MOQ	Montech Holdings Limited
MOX	Monax Mining Ltd
MOY	Millennium Minerals Ltd
MP1	Megaport Limited
MPL	Medibank Private Limited
MPLBON	Medibank Private Limited
MPLBOR	Medibank Private Limited
MPLKOA	Medibank Private Limited
MPLKOE	Medibank Private Limited
MPLKOP	Medibank Private Limited
MPLKOS	Medibank Private Limited
MPO	Molopo Australia Ltd
MPP	Metro Performance Glass Limited
MPW	Msl Solutions Limited
MPX	Mustera Property Group Limited
MQG	Macquarie Group Ltd
MQGBOA	Macquarie Group Limited
MQGBON	Macquarie Group Limited
MQGKOB	Macquarie Group Limited
MQGKOC	Macquarie Group Limited
MQGKOD	Macquarie Group Limited
MQGKOG	Macquarie Group Limited
MQGKOH	Macquarie Group Limited
MQGKOI	Macquarie Group Limited
MQGKOJ	Macquarie Group Limited
MQGKON	Macquarie Group Limited
MQGKOP	Macquarie Group Limited
MQGKOQ	Macquarie Group Limited
MQGKOR	Macquarie Group Limited
MQGKOV	Macquarie Group Limited
MQGKOX	Macquarie Group Limited
MQGKOY	Macquarie Group Limited
MQGKOZ	Macquarie Group Limited
MQGLOA	Macquarie Group Limited
MQGLOB	Macquarie Group Limited
MQGLOD	Macquarie Group Limited
MQGLOL	Macquarie Group Limited
MQGLOM	Macquarie Group Limited
MQGLOQ	Macquarie Group Limited
MQGLOR	Macquarie Group Limited
MQGLOS	Macquarie Group Limited
MQGMOA	Macquarie Group Limited
MQGPB	Macquarie Group Limited
MQGPC	Macquarie Group Limited
MQR	Marquee Resources Limited
MQRO	Marquee Resources Limited
MRC	Mineral Commodities Ltd
MRD	Mount Ridley Mines Limited
MRDOA	Mount Ridley Mines Limited
MRG	Murray River Organics Group Limited
MRL	Miller's Retail Ltd
MRM	Mermaid Marine Australia Ltd
MRN	Macquarie Radio Network Ltd
MRP	Macphersons Reward Gold Limited
MRQ	Mrg Metals Limited
MRQOA	Mrg Metals Limited
MRQOB	Mrg Metals Limited
MRR	Minrex Resources Nl
MRV	Moreton Resources Ltd
MSB	Mesoblast Ltd
MSBKOE	Mesoblast Limited
MSBKOQ	Mesoblast Limited
MSBKOR	Mesoblast Limited
MSBKOS	Mesoblast Limited
MSE	Metalsearch Limited
MSEOA	Metalsearch Limited
MSG	Mcs Services Limited
MSI	Multistack International Ltd
MSM	Msm Corporation International Ltd
MSMOA	Msm Corporation International Ltd
MSP	Maxsec Group Limited
MSR	Manas Resources Ltd
MSV	Mitchell Services Limited
MTB	Mount Burgess Mining NL
MTC	Metalstech Limited
MTH	Mithril Resources Ltd
MTL	Manalto Limited
MTM	Mareterram Limited
MTO	Moto Goldmines Ltd
MTS	Metcash Ltd
MTSKOB	Metcash Limited
MTSKOD	Metcash Limited
MTSKOQ	Metcash Limited
MTSKOR	Metcash Limited
MTSKOS	Metcash Limited
MUA	Mitula Group Limited
MUS	Mustang Group
MUSOA	Mustang Resources Limited
MVA	MVA
MVB	MVB
MVE	MVE
MVF	Monash Ivf Group Limited
MVOL	MVOL
MVP	Medical Developments International
MVR	MVR
MVS	MVS
MVT	Mercantile Investment Company Ltd
MVTHA	Mercantile Investment Company Ltd
MVW	MVW
MWR	MGM Wireless Ltd
MWY	Midway Limited
MX1	Micro-x Limited
MXC	Mgc Pharmaceuticals Ltd
MXCOD	Mgc Pharmaceuticals Ltd
MXI	MaxiTRA Industries Ltd
MXR	Maximus Resources Ltd
MXT	Mcp Master Income Trust
MXUPA	MXU
MYE	Mastermyne Group Limited
MYL	Myanmar Metals Limited
MYLO	Myanmar Metals Limited
MYO	MYOB Ltd
MYOKOA	Myob Group Limited
MYOKOQ	Myob Group Limited
MYOKOR	Myob Group Limited
MYQ	Myfiziq Limited
MYR	Myer Holdings Limited
MYRBOR	Myer Holdings Limited
MYRKOB	Myer Holdings Limited
MYRKOP	Myer Holdings Limited
MYRKOQ	Myer Holdings Limited
MYRKOR	Myer Holdings Limited
MYRKOS	Myer Holdings Limited
MYS	Mystate Limited
MYX	MYX
MYXKOA	Mayne Pharma Group Limited
MYXKOB	Mayne Pharma Group Limited
MYXKOC	Mayne Pharma Group Limited
MYXKOD	Mayne Pharma Group Limited
MZI	Matilda Zircon Limited
MZN	Marindi Metals Limited
MZZ	Matador Mining Limited
MZZO	Matador Mining Limited
N1H	N1 Holdings Limited
N27	Northern Cobalt Limited
N27O	Northern Cobalt Limited
NAB	National Australia Bank Ltd
NABBOA	National Australia Bank Limited
NABBOB	National Australia Bank Limited
NABBOD	National Australia Bank Limited
NABBOF	National Australia Bank Limited
NABBOH	National Australia Bank Limited
NABBON	National Australia Bank Limited
NABBOR	National Australia Bank Limited
NABHA	NABHA
NABKOA	National Australia Bank Limited
NABKOD	National Australia Bank Limited
NABKOG	National Australia Bank Limited
NABKOH	National Australia Bank Limited
NABKOI	National Australia Bank Limited
NABKOJ	National Australia Bank Limited
NABKOK	National Australia Bank Limited
NABKOL	National Australia Bank Limited
NABKON	National Australia Bank Limited
NABKOP	National Australia Bank Limited
NABKOQ	National Australia Bank Limited
NABKOR	National Australia Bank Limited
NABKOT	National Australia Bank Limited
NABKOV	National Australia Bank Limited
NABKOW	National Australia Bank Limited
NABKOX	National Australia Bank Limited
NABKOY	National Australia Bank Limited
NABKOZ	National Australia Bank Limited
NABLOA	National Australia Bank Limited
NABLOB	National Australia Bank Limited
NABLOD	National Australia Bank Limited
NABLOF	National Australia Bank Limited
NABLOG	National Australia Bank Limited
NABLOP	National Australia Bank Limited
NABLOQ	National Australia Bank Limited
NABLOR	National Australia Bank Limited
NABLOS	National Australia Bank Limited
NABLOT	National Australia Bank Limited
NABLOW	National Australia Bank Limited
NABMOP	National Australia Bank Limited
NABPA	National Australia Bank Limited
NABPB	National Australia Bank Limited
NABPC	National Australia Bank Limited
NABPD	National Australia Bank Limited
NABPE	National Australia Bank Limited
NAC	Naos Absolute Opportunities Company Limited
NAE	New Age Exploration Ltd
NAG	
NAM	Namoi Cotton Co-operative Ltd
NAN	Nanosonics Ltd
NANKOB	Nanosonics Limited
NAV	Navigator Resources Ltd
NBL	Noni B Ltd
NC6	Nanollose Limited
NC6O	Nanollose Limited
NCC	Naos Emerging Opportunities Company Limited
NCK	Nick Scali Ltd
NCL	Netccentric Limited
NCM	Newcrest Mining Ltd
NCMKOA	Newcrest Mining Limited
NCMKOC	Newcrest Mining Limited
NCMKOE	Newcrest Mining Limited
NCMKOH	Newcrest Mining Limited
NCMKOI	Newcrest Mining Limited
NCMKOJ	Newcrest Mining Limited
NCMKOL	Newcrest Mining Limited
NCMKOP	Newcrest Mining Limited
NCMKOV	Newcrest Mining Limited
NCMKOX	Newcrest Mining Limited
NCMKOY	Newcrest Mining Limited
NCMLOA	Newcrest Mining Limited
NCMLOC	Newcrest Mining Limited
NCMLOD	Newcrest Mining Limited
NCMLOF	Newcrest Mining Limited
NCMLOR	Newcrest Mining Limited
NCMLOS	Newcrest Mining Limited
NCMLOU	Newcrest Mining Limited
NCMMOQ	Newcrest Mining Limited
NCR	Nucoal Resources Nl
NCZ	New Century Resources Limited
NDQ	NDQ
NDXKOC	NDXKOC
NDXKOD	NDXKOD
NDXKOE	NDXKOE
NDXKOF	NDXKOF
NDXKOG	NDXKOG
NDXKOJ	NDXKOJ
NDXKOK	NDXKOK
NDXKOP	Nasdaq 100 E-mini
NDXKOQ	Nasdaq 100 E-mini
NDXKOS	Nasdaq 100 E-mini
NDXKOU	Nasdaq 100 E-mini
NDXKOW	NDXKOW
NDXKOX	NDXKOX
NDXKOY	NDXKOY
NDXMOY	NDXMOY
NEA	Nearmap Ltd
NEC	Nine Entertainment Co Holdings Ltd
NECKOA	Nine Entertainment Co. Holdings Limited
NECKOB	Nine Entertainment Co. Holdings Limited
NECKOE	Nine Entertainment Co. Holdings Limited
NECKOP	Nine Entertainment Co. Holdings Limited
NECKOQ	Nine Entertainment Co. Holdings Limited
NES	Nelson Resources Limited.
NESO	Nelson Resources Limited.
NET	Netlinkz Limited
NEU	Neuren Pharmaceuticals Ltd
NEW	New Energy Solar
NEWOA	New Energy Solar
NEWOB	New Energy Solar
NFNG	NFNG
NGE	New Guinea Energy Ltd
NGI	Navigator Global Investments Limited
NGY	Nuenergy Capital Ltd
NHC	New Hope Corporation Ltd
NHF	Nib Holdings Ltd
NHL	Nova Health Ltd
NI2KOA	NI2KOA
NI2KOC	NI2KOC
NI2KOD	NI2KOD
NI2KOE	NI2KOE
NI2KOF	NI2KOF
NI2KOP	NI2KOP
NI2KOT	NI2KOT
NI2KOV	NI2KOV
NIO	Nicklelore Ltd
NIU	Niuminco Group Limited
NIUO	Niuminco Group Limited
NKP	Nkwe Platinum Ltd
NLI	Novo Litio Ltd
NME	Nex Metals Exploration Ltd
NMI	Northern Mining Ltd
NML	Navarre Minerals Limited
NMM	Noble Metals Limited
NMS	Neptune Marine Services Ltd
NMT	Neometals Ltd
NNW	99 Wuxian Limited
NOR	Norwood Systems Limited
NOV	Novatti Group Limited
NOX	Noxopharm Limited
NSB	Neuroscientific Biopharmaceuticals Ltd
NSC	Naos Small Cap Opportunities Company Limited
NSCG	Naos Small Cap Opportunities Company Limited
NSE	New Standard Energy Ltd
NSL	L Health Ltd
NSR	National Storage Reit
NSRKOB	National Storage Reit
NST	Northern Star Resources Ltd
NSTKOA	Northern Star Resources Ltd
NSTKOB	Northern Star Resources Ltd
NSTKOE	Northern Star Resources Ltd
NSTKOQ	Northern Star Resources Ltd
NSTKOR	Northern Star Resources Ltd
NSTKOS	Northern Star Resources Ltd
NSX	X Ltd
NTC	Netcomm Ltd
NTD	National Tyre & Wheel Limited
NTI	Neurotech International Limited
NTL	New Talisman Gold Mines Limited
NTM	Northern Manganese Limited
NTU	Northen Uranium Ltd
NUF	NuFarm Ltd
NUFKOB	Nufarm Limited
NUFKOD	Nufarm Limited
NUFKOP	Nufarm Limited
NUFKOR	Nufarm Limited
NUH	Nuheara Limited
NUS	Nusantara Resources Limited
NUSO	Nusantara Resources Limited
NUSOA	Nusantara Resources Limited
NVA	Nova Minerals Limited
NVAO	Nova Minerals Limited
NVL	National Veterinary Care Ltd
NVO	Nvoi Ltd
NVT	Navitas Ltd
NVTKOA	Navitas Limited
NVTKOB	Navitas Limited
NVTKOP	Navitas Limited
NVTKOS	Navitas Limited
NVX	Novonix Limited
NWC	New World Cobalt Limited
NWE	Norwest Energy NL
NWF	Newfield Resources Limited
NWH	NRW Holdings Ltd
NWL	New Tel
NWS	News Corporation
NWSLV	NEWS CORP-PREFD
NXM	Nexus Minerals Limited
NXR	Nemex Resources Limited
NXT	Nextdc Limited
NXTKOA	Nextdc Limited
NXTKOB	Nextdc Limited
NXTKOC	Nextdc Limited
NXTKOD	Nextdc Limited
NXTKOE	Nextdc Limited
NXTKOF	Nextdc Limited
NXTKOG	Nextdc Limited
NXTKOH	Nextdc Limited
NZC	Nzuri Copper Limited
NZK	New Zealand King Salmon Investments Limited
NZM	Nzme Limited
OAR	Oakdale Resources Limited
OBJ	OBJ Ltd
OCA	Oil Company Of Australia
OCC	Orthocell Limited
OCL	Objective Corporation Ltd
OCP	Oceania Capital Partners Limited
ODM	Odin Metals Limited
ODY	Odyssey Energy Ltd
OEC	Orbital Corporation Ltd
OEL	Ottoman Energy Ltd
OEQ	Orion Equities Ltd
OEX	Oilex NL
OFX	Ozforex Group Limited
OFXKOA	Ozforex Group Limited
OFXKOE	Ozforex Group Limited
OFXKOQ	Ozforex Group Limited
OFXKOR	Ozforex Group Limited
OGA	Ocean Grown Abalone Limited
OGC	Oceanagold Corporation
OGX	Orinoco Gold Limited
OGXOD	Orinoco Gold Limited
OHE	Orion Health Group Limited
OIL	Optiscan Imaging Ltd
OKJ	Oakajee Corporation Ltd
OKR	Okapi Resources Limited
OKU	Oklo Uranium Ltd
OLH	Oldfields Holdings Ltd
OLI	Olivers Real Food Limited
OLV	Otherlevels Holdings Limited
OMH	OM Holdings Ltd
OML	Ooh!media Limited
OMN	Onemarket Limited
OMT	Omni Market Tide Ltd
OMTO	Omni Market Tide Ltd
ONE	Oneview Healthcare Plc
ONT	1300 Smiles Ltd
ONX	Orminex Ltd
OOK	Ookami Limited
OOO	Betashares Crude Oil Index Etf-currency Hedged (synthetic)
OPG	Opus Group Limited
OPN	Opendna Limited
OPT	Opthea Limited
OPTO	Opthea Limited
ORA	Orora Limited
ORAKOA	Orora Limited
ORAKOB	Orora Limited
ORAKOP	Orora Limited
ORAKOQ	Orora Limited
ORE	Orocobre Ltd
OREKOA	Orocobre Limited
OREKOD	Orocobre Limited
ORG	Origin Energy Ltd
ORGKOA	Origin Energy Limited
ORGKOC	Origin Energy Limited
ORGKOF	Origin Energy Limited
ORGKOP	Origin Energy Limited
ORGKOQ	Origin Energy Limited
ORGKOR	Origin Energy Limited
ORH	Orient Resource Holdings Ltd
ORI	Orica Ltd
ORIBOA	Orica Limited
ORIBOD	Orica Limited
ORIBOF	Orica Limited
ORIBON	Orica Limited
ORIKOB	Orica Limited
ORIKOD	Orica Limited
ORIKOQ	Orica Limited
ORIKOS	Orica Limited
ORIKOT	Orica Limited
ORL	OrotonGroup Ltd
ORM	Orion Metals Limited
ORN	ORN
ORR	Orecorp Limited
OSH	Oil Search Ltd (PNG)
OSHKOA	Oil Search Limited
OSHKOB	Oil Search Limited
OSHKOQ	Oil Search Limited
OSHKOT	Oil Search Limited
OSHQOB	Oil Search Limited
OSL	Oncosil Medical Ltd
OSP	Osprey Medical Inc
OTI	Oriental Technologies Investment Ltd
OTR	Otter Gold Mines
OTW	Over The Wire Holdings Limited
OVH	Onevue Holdings Limited
OVL	Oro Verde Limited
OVN	Oventus Medical Limited
OXX	Octanex N.l.
OZF	Spdr S&p/asx 200 Financials Ex A-reit Fund
OZG	Ozgrowth Ltd
OZGOC	Ozgrowth Limited
OZL	OZ Minerals
OZLKOA	Oz Minerals Limited
OZLKOB	Oz Minerals Limited
OZLKOD	Oz Minerals Limited
OZLKOE	Oz Minerals Limited
OZLKOG	Oz Minerals Limited
OZLKOQ	Oz Minerals Limited
OZLKOR	Oz Minerals Limited
OZLKOS	Oz Minerals Limited
OZR	Spdr S&p/asx 200 Resources Fund
P2P	P2p Transport Limited
PAA	PharmAust Ltd
PAB	Patrys Ltd
PAC	Pacsoft Ltd
PAF	Pm Capital Asian Opportunities Fund Limited
PAI	Platinum Asia Investments Limited
PAK	Pacific American Coal Limited
PAN	Panoramic Resources Ltd
PAR	Paradigm Biopharmaceuticals Limited..
PBP	Probiotec Ltd
PBT	Prana Biotechnology Ltd
PBX	Pacific Bauxite Limited
PC1	Plus Connect Limited
PCG	PCH Group Ltd
PCH	Property Connect Holdings Limited
PCK	Painchek Ltd
PCL	Pancontinental Oil & Gas NL
PDF	Pacific Dairies Limited
PDI	Predictive Discovery Limited
PDIO	Predictive Discovery Limited
PDL	Petra Diamonds Ltd
PDLKOB	Pendal Group Limited
PDLKOC	Pendal Group Limited
PDN	Paladin Resources Ltd
PDZ	Prairie Downs Metals Ltd
PEA	Pacific Energy Ltd
PEC	Perpetual Resources Limited
PEK	Peak Resources Ltd
PEKOB	Peak Resources Limited
PEKOC	Peak Resources Limited
PEL	Pelican Resources Ltd
PEN	Peninsula Minerals Ltd
PENOD	Peninsula Energy Limited
PEX	Peel Exploration Ltd
PFG	Prime Financial Group Ltd
PFP	WC Penfold
PG1	Pearl Global Limited
PG1OB	Pearl Global Limited
PGC	Paragon Care Ltd
PGF	Pm Capital Global Opportunities Fund Limited
PGH	Pact Group Holdings Ltd
PGI	Panterra Gold Limited
PGIOA	Panterra Gold Limited
PGM	Platina Resources Ltd
PGR	The Pas Group Limited
PGS	Planet Gas Ltd
PGX	Primero Group Limited
PGY	Pilot Energy Limited
PHI	Phileo Australia Ltd
PHK	Phoslock Water Solutions Ltd
PIA	Prudential Investment Company Of Australia
PIAO	Pengana International Equities Limited
PIC	Perpetual Equity Investment Company Limited
PIL	Pilbara Mines NL.
PIO	Pioneer Nickel Ltd
PIOO	Pioneer Resources Limited
PIQ	Proteomics International Laboratories Ltd
PKA	Plukka Limited
PKD	Parkd Ltd
PKO	Peak Oil & Gas Limited
PL8	Plato Income Maximiser Limited.
PL8O	Plato Income Maximiser Limited.
PLC	Plc Financial Solutions Limited
PLG	Propertylink Group
PLL	Poltech International
PLS	Pilbara Minerals Limited
PLX	Plexus International
PM1	Pure Minerals Limited
PM1O	Pure Minerals Limited
PMC	Platinum Capital Ltd
PME	Pro Medicus Ltd
PMGOLD	PMGOLD
PMP	PMP Ltd
PMV	Premier Investments Ltd
PMVKOA	Premier Investments Limited
PMVKOB	Premier Investments Limited
PMVKOC	Premier Investments Limited
PMVKOP	Premier Investments Limited
PMVKOR	Premier Investments Limited
PMY	Pacifico Minerals Limited
PNC	Pioneer Credit Limited
PNI	Pinnacle Investment Management Group Ltd
PNL	Paringa Resources Limited
PNN	PeppinNini Minerals Ltd
PNR	Pacific Niugini Minerals Ltd
PNV	Polynovo Limited
PNW	Pacific Star Network Ltd
PNX	Phoenix Copper Ltd
PO3	Purifloh Limited
POD	Podium Minerals Limited
PODO	Podium Minerals Limited
POH	Phosphagenics Ltd
POS	Poseidon Nickel Ltd
POU	Betashares British Pound Etf
POW	Protean Wave Energy Ltd
POZ	Phosphate Auctralia Ltd
PPC	Peet & Company Ltd
PPCHA	Peet Limited
PPCHB	Peet Limited
PPE	People Infrastructure Ltd
PPG	Pro-Pac Packaging Ltd
PPH	Pan Pharmaceuticals
PPK	Plaspak Group Ltd
PPL	Park Plaza Kemayan
PPS	Praemium Ltd
PPT	Perpetual Trustees Australia Ltd
PPTKOD	Perpetual Limited
PPTKOF	Perpetual Limited
PPTKOG	Perpetual Limited
PPTKOP	Perpetual Limited
PPTKOQ	Perpetual Limited
PPTKOR	Perpetual Limited
PPY	Papyrus Australia Ltd
PRL	Petrel Energy Limited
PRLOA	Petrel Energy Limited
PRO	Prophecy International Holdings Ltd
PRT	Prime Television Ltd
PRU	Perseus Mining Ltd
PRX	Prime Retail Group unit/ord
PRY	Primary Healthcare Ltd
PRYKOA	Primary Health Care Limited
PRYKOB	Primary Health Care Limited
PRYKOC	Primary Health Care Limited
PRYKOF	Primary Health Care Limited
PRYKOQ	Primary Health Care Limited
PRYKOT	Primary Health Care Limited
PRZ	Primary Resources Ltd
PSA	Petsec Energy Ltd
PSC	Prospect Resources Limited
PSI	Pacific Strategic Investments Ltd
PSM	Peninsula Mines Limited
PSQ	Pacific Smiles Group Limited
PSY	PSY
PSZ	Ps&c Limited
PTB	PTB Group Ltd
PTL	Pental Limited
PTM	Platinum Asset Management Ltd
PTMKOC	Platinum Asset Management Limited
PTMKOP	Platinum Asset Management Limited
PTMKOS	Platinum Asset Management Limited
PTR	Petratherm Ltd
PTX	Prescient Therapeutics Limited
PUN	Pegasus Metals Ltd
PUR	Purus Energy Ltd
PVD	Pura Vida Energy Nl
PVE	Po Valley Energy Ltd
PVL	Powerhouse Ventures Limited
PVS	Pivotal Systems Corporation Inc.
PWH	Pwr Holdings Limited
PWN	Potash West Nl
PWNCA	Potash West Nl
PWNOA	Potash West Nl
PXS	Pharmaxis Ltd
PXX	Polarx Limited
PYC	Phylogica Ltd
PYG	Paygroup Limited
PZC	Pan Asia Corporation Limited
QAG	Betashares Agriculture Etf-currency Hedged (synthetic)
QAN	Qantas Airways Ltd
QANBOD	Qantas Airways Limited
QANKOC	Qantas Airways Limited
QANKOD	Qantas Airways Limited
QANKOF	Qantas Airways Limited
QANKOP	Qantas Airways Limited
QANKOQ	Qantas Airways Limited
QANKOT	Qantas Airways Limited
QANKOY	Qantas Airways Limited
QAU	Betashares Gold Bullion Etf (a$ Hedged)
QBE	QBE Insurance Group Ltd
QBEBOA	Qbe Insurance Group Limited
QBEBOB	Qbe Insurance Group Limited
QBEBOD	Qbe Insurance Group Limited
QBEBOH	Qbe Insurance Group Limited
QBEBON	Qbe Insurance Group Limited
QBEBOQ	Qbe Insurance Group Limited
QBEBOR	Qbe Insurance Group Limited
QBEKOA	Qbe Insurance Group Limited
QBEKOB	Qbe Insurance Group Limited
QBEKOG	Qbe Insurance Group Limited
QBEKOH	Qbe Insurance Group Limited
QBEKOS	Qbe Insurance Group Limited
QBEKOU	Qbe Insurance Group Limited
QBEKOV	Qbe Insurance Group Limited
QBEKOX	Qbe Insurance Group Limited
QBELOA	Qbe Insurance Group Limited
QBELOC	Qbe Insurance Group Limited
QBELOD	Qbe Insurance Group Limited
QBELOE	Qbe Insurance Group Limited
QBELOF	Qbe Insurance Group Limited
QBELOJ	Qbe Insurance Group Limited
QBELOP	Qbe Insurance Group Limited
QBELOQ	Qbe Insurance Group Limited
QBELOS	Qbe Insurance Group Limited
QBELOT	Qbe Insurance Group Limited
QBELOU	Qbe Insurance Group Limited
QBELOV	Qbe Insurance Group Limited
QBL	Queensland Bauxite Limited
QCB	Betashares Commodities Basket Etf-currency Hedged(synthetic)
QFN	Betashares S&p/asx 200 Financials Sector Etf (synthetic)
QFY	Quantify Technology Holdings Limited
QGL	Quantum Graphite Limited
QHL	Quickstep Holdings Ltd
QIN	Quintis Ltd
QIP	Qantm Intellectual Property Limited
QMS	Qms Media Limited
QOZ	QOZ
QPON	QPON
QRE	Betashares S&p/asx 200 Resources Sector Etf (synthetic)
QSS	Questus Ltd
QST	Quest Investments Ltd
QTG	QTG
QTM	Quantum Energy Ltd
QUAL	QUAL
QUB	Qube Logistics
QUBHA	Qube Holdings Limited
QUBKOA	Qube Holdings Limited
QUBKOB	Qube Holdings Limited
QUBKOC	Qube Holdings Limited
QUE	Queste Communications Ltd
QUS	QUS
QVE	Qv Equities Limited
R3D	Redchip International Limited
RAC	Reinsurance Australia Corporation
RAN	Range International Limited
RAP	Resapp Health Limited
RAW	Rawson Resources Ltd
RBD	Restaurant Brands New Zealand Limited
RBL	Rib Loc Group
RBO	Robo 3d Limited
RBR	Rubicon Resources Ltd
RBX	Resources Base Ltd
RCB	Russell Australian Select Corporate Bond Etf
RCE	Recce Limited
RCL	Repco Corporation Ltd
RCLO	Readcloud Limited
RCO	Royalco Resources Ltd
RCP	Redbank Copper Limited
RCR	RCR Tomlinson Ltd
RCT	Reef Casino Trust
RCW	Rightcrowd Limited
RD1	Registry Direct Limited
RD1O	Registry Direct Limited
RDF	Redflex Holdings Ltd
RDG	Resource Development Group Limited
RDH	Redhill Education Limited
RDM	Red Metal Ltd
RDN	Raiden Resources Limited
RDS	Redstone Resources Ltd
RDV	Russell High Dividend Australian Shares Etf
REA	realestate.com.au Ltd
REAKOA	Rea Group Ltd
REAKOF	Rea Group Ltd
REAKOQ	Rea Group Ltd
REAKOR	Rea Group Ltd
RED	Red 5 Ltd
REF	Reverse Corp Ltd
REG	RG Capital Radio
REGKOA	Regis Healthcare Limited
REGKOB	Regis Healthcare Limited
REH	Reece Australia Ltd
REL	Renewable Energy Corporation Ltd
RELO	Raven Energy Limited
RENT	RENT
RES	Resource Generation Ltd
REV	Revenir Ltd
REX	Regional Express Holdings Ltd
REY	Rey Resources Ltd
REZ	Resources & Energy Group Limited
RFF	Rural Funds Group
RFG	Retail Food Group Ltd
RFN	Reffind Limited
RFR	Rafaella Resources Ltd.
RFT	Rectifier Technologies Ltd
RFX	Redflow Limited
RGB	Russell Australian Government Bond Etf
RGI	Roto-gro International Limited
RGL	Ruralco Holdings Ltd
RGP	Refresh Group Ltd
RGS	Regeneus Ltd
RHC	Ramsay Health Care Ltd
RHCKOB	Ramsay Health Care Limited
RHCKOP	Ramsay Health Care Limited
RHCKOQ	Ramsay Health Care Limited
RHCKOR	Ramsay Health Care Limited
RHCPA	Ramsay Health Care Ltd
RHI	Red Hill Iron Ltd
RHL	Ruralco Holdings Ltd
RHP	Rhype Limited
RHT	Resonance Health Ltd
RHY	Rhythm Biosciences Limited
RIC	Ridley Corporation Ltd
RIE	Riedel Resources Limited
RIM	Rimfire Pacific Mining NL
RINC	RINC
RIO	Rio Tinto Ltd
RIOBOA	Rio Tinto Limited
RIOBOD	Rio Tinto Limited
RIOBOR	Rio Tinto Limited
RIOKOC	Rio Tinto Limited
RIOKOD	Rio Tinto Limited
RIOKOE	Rio Tinto Limited
RIOKOH	Rio Tinto Limited
RIOKOI	Rio Tinto Limited
RIOKOJ	Rio Tinto Limited
RIOKOK	Rio Tinto Limited
RIOKOL	Rio Tinto Limited
RIOKOM	Rio Tinto Limited
RIOKOO	Rio Tinto Limited
RIOKOP	Rio Tinto Limited
RIOKOR	Rio Tinto Limited
RIOKOV	Rio Tinto Limited
RIOKOY	Rio Tinto Limited
RIOKOZ	Rio Tinto Limited
RIOLOA	Rio Tinto Limited
RIOLOB	Rio Tinto Limited
RIOLOD	Rio Tinto Limited
RIOLOF	Rio Tinto Limited
RIOLOG	Rio Tinto Limited
RIOLOP	Rio Tinto Limited
RIOLOQ	Rio Tinto Limited
RIOLOR	Rio Tinto Limited
RIOLOS	Rio Tinto Limited
RIOLOT	Rio Tinto Limited
RIOLOU	Rio Tinto Limited
RIOMOQ	Rio Tinto Limited
RIOMOR	Rio Tinto Limited
RIOMOU	Rio Tinto Limited
RKN	Reckon Ltd
RLC	Revere Mining
RLCO	Reedy Lagoon Corporation Limited
RLE	Real Energy Corporation Limited
RMD	ResMed Inc (USA CUFS)
RMDKOE	Resmed Inc
RMDKOP	Resmed Inc
RMG	RMG Ltd
RMI	Resource Mining Corporation Ltd
RMP	Red Emperor Resources NL
RMS	Ramelius Resources Ltd
RMT	RMA Energy Ltd
RMX	Red Mountain Mining Limited
RMXOG	Red Mountain Mining Limited
RMXOH	Red Mountain Mining Limited
RMY	Rma Global Limited
RND	Rand Mining NL
RNE	Renu Energy Limited
RNL	Rision Limited
RNO	Rhinomed Limited
RNT	Rent.com.au Limited
RNU	Renaissance Uranium Limited
RNUOA	Renascor Resources Limited
RNX	Renegade Exploration Limited
RNY	Reckson New York Property Trust
ROBO	Robe Australia Limited
ROG	Red Sky Energy Ltd
ROO	Roots Sustainable Agricultural Technologies Ltd
RPG	Raptis Group Ltd
RRL	Regis Resources NL
RRLKOB	Regis Resources Limited
RRLKOE	Regis Resources Limited
RRS	Range Resources Ltd
RSG	Resolute Mining Ltd
RSGG	Resolute Mining Ltd
RSGKOA	Resolute Mining Limited
RSGKOB	Resolute Mining Limited
RSGKOC	Resolute Mining Limited
RSGKOR	Resolute Mining Limited
RSH	Respiri Limited
RSM	Russell Australian Semi-government Bond Etf
RTE	Retech Technology Co., Limited
RTG	Rtg Mining Inc.
RTR	Rumble Resources Limited
RUB	Rubicor Group Ltd
RUL	Runge Ltd
RVA	Reva Medical Inc
RVR	Red River Resources Ltd
RVY	Rift Valley Resources Limited.
RWC	Reliance Worldwide Corporation Limited
RWCKOA	Reliance Worldwide Corporation Limited
RWD	Reward Minerals Ltd
RXH	Rewardle Holdings Limited
RXL	Rox Resources Ltd
RXM	Rex Minerals Ltd
RXP	Rxp Services Limited
RYD	Ryder Capital Limited
RYDO	Ryder Capital Limited
RZI	Raiz Invest Limited
S2R	S2 Resources Ltd
S32	South32 Limited
S32BOA	South32 Limited
S32BON	South32 Limited
S32KOA	South32 Limited
S32KOB	South32 Limited
S32KOC	South32 Limited
S32KOE	South32 Limited
S32KOR	South32 Limited
S32KOS	South32 Limited
S32KOT	South32 Limited
S32KOU	South32 Limited
S32KOV	South32 Limited
S32QOA	South32 Limited
S3R	Serpentine Technologies Limited
S3RO	Serpentine Technologies Limited
S3ROA	Serpentine Technologies Limited
S3ROB	Serpentine Technologies Limited
S66	Star Combo Pharma Limited
SAM	Siv Asset Management Limited
SAN	Sagalio Energy Limited
SAR	Saracen Mineral Holdings Ltd
SARKOA	Saracen Mineral Holdings Limited
SARKOB	Saracen Mineral Holdings Limited
SAS	Sky And Space Global Ltd
SAU	Southern Gold Ltd
SAY	South American Iron & Steel Corporation Ltd
SBB	Sunbridge Group Limited
SBI	Sterling Biofuels International Ltd
SBKHB	Suncorp-metway Limited .
SBM	St Barbara Mines Ltd
SBR	Sabre Resources Ltd
SBRO	Sabre Resources Ltd
SBU	Siburan Resources Limited
SCG	Scentre Group
SCGBOA	Scentre Group
SCGBON	Scentre Group
SCGBOR	Scentre Group
SCGKOD	Scentre Group
SCI	Silver City Minerals Limited
SCL	Schrole Group Ltd
SCO	Scottish Pacific Group Limited
SCP	Shopping Centres Australasia Property Group
SCPKOA	Shopping Centres Australasia Property Group
SCPKOC	Shopping Centres Australasia Property Group
SCPKOD	Shopping Centres Australasia Property Group
SCPKOQ	Shopping Centres Australasia Property Group
SCPKOR	Shopping Centres Australasia Property Group
SCT	Scout Security Limited
SCU	Stemcell United Limited
SDA	Speedcast International Limited
SDAKOA	Speedcast International Limited
SDAKOB	Speedcast International Limited
SDF	Steadfast Group Limited
SDG	Sunland Group Ltd
SDI	SDI Ltd
SDL	Sundance Resources Ltd
SDV	Scidev Ltd
SDX	Sienna Cancer Diagnostics Limited
SE1	Sensera Limited
SEA	Sundance Energy Australia Ltd
SEC	Spheria Emerging Companies Limited
SEH	Sino Gas & Energy Holdings Limited
SEI	Speciality Metals International Limited
SEK	Seek Ltd
SEKKOB	Seek Limited
SEKKOQ	Seek Limited
SEKKOS	Seek Limited
SEKQOA	Seek Limited
SEN	Senetas Corporation Ltd
SEQ	Southern Equity Holdings
SER	Strategic Energy Resources Ltd
SES	Solar Energy Systems
SFC	Schaffer Corporation Ltd
SFG	St Francis Group Ltd
SFGO	Seafarms Group Limited
SFH	Specialty Fashion Group Ltd
SFI	Spookfish Limited
SFL	Spring Fg Limited
SFM	Santa Fe Minerals Ltd
SFR	Sandfire Resources NL
SFRKOA	Sandfire Resources Nl
SFRKOD	Sandfire Resources Nl
SFRKOE	Sandfire Resources Nl
SFRKOJ	Sandfire Resources Nl
SFRKOL	Sandfire Resources Nl
SFRKOQ	Sandfire Resources Nl
SFRKOR	Sandfire Resources Nl
SFRKOS	Sandfire Resources Nl
SFRKOT	Sandfire Resources Nl
SFRKOV	Sandfire Resources Nl
SFX	Sheffield Resources Limited
SFY	StreetTracks S&P/ASX 50 Fund
SGC	Sydney Gas Company Nl
SGF	Sg Fleet Group Limited
SGH	Slater & Gordon Ltd
SGM	Sims Group Ltd
SGMKOA	Sims Metal Management Limited
SGMKOD	Sims Metal Management Limited
SGMKOE	Sims Metal Management Limited
SGMKOP	Sims Metal Management Limited
SGMKOR	Sims Metal Management Limited
SGMKOT	Sims Metal Management Limited
SGMKOV	Sims Metal Management Limited
SGO	Stream Group Limited
SGP	Stockland
SGPKOC	Stockland
SGPKOF	Stockland
SGPKOQ	Stockland
SGPKOR	Stockland
SGPKOS	Stockland
SGQ	St George Mining Limited
SGQOB	St George Mining Limited
SGR	The Star Entertainment Group Limited
SGRBON	The Star Entertainment Group Limited
SGRKOA	The Star Entertainment Group Limited
SGRKOD	The Star Entertainment Group Limited
SGRKOQ	The Star Entertainment Group Limited
SGRKOR	The Star Entertainment Group Limited
SGU	Success Resources Global Ltd
SHH	Shree Minerals Limited
SHI	Shine Metals Limited
SHJ	Shine Corporate Ltd
SHK	Stone Resources Australia Limited
SHL	Sonic Healthcare Ltd
SHLKOB	Sonic Healthcare Limited
SHLKOC	Sonic Healthcare Limited
SHLKOP	Sonic Healthcare Limited
SHM	Shriro Holdings Limited
SHO	Sportshero Limited
SHU	Shenhua International Limited
SHV	Select Harvests Ltd
SI6	Six Sigma Metals Limited
SI6OC	Six Sigma Metals Limited
SIE	SciGen Ltd (Singapore)
SIG	Sigma Company Ltd
SIGKOB	Sigma Healthcare Limited
SIH	Sihayo Gold Limited
SIL	Smiles Inclusive Limited
SIO	Simonds Group Limited
SIQ	Smartgroup Corporation Ltd
SIS	Simble Solutions Limited
SIT	SIT
SIV	Silver Chef Ltd
SIX	Sprintex Limited
SKC	Sky City Entertainment Group Ltd
SKF	Skyfii Ltd
SKI	Spark Infrastructure Group
SKIKOB	Spark Infrastructure Group
SKIKOD	Spark Infrastructure Group
SKIKOQ	Spark Infrastructure Group
SKIKOR	Spark Infrastructure Group
SKN	Skansen Holdings
SKNO	Skin Elements Limited
SKO	Serko Limited
SKP	Skyland Petroleum Limited
SKS	Stokes (Australasia) Ltd
SKT	Sky Network Television Ltd
SL1	Symbol Mining Limited
SL1O	Symbol Mining Limited
SLC	Softlaw Corporation Ltd
SLF	StreetTracks 200 Listed Proprty Fund
SLK	Sealink Travel Group Limited
SLM	Salmat Ltd
SLR	Silver Lake Resources Ltd
SLX	Silex Systems Ltd
SM1	Synlait Milk Limited
SM8	Shark Mitigation Systems Limited
SMA	SmartTrans Holdings Ltd
SMC	Strategic Minerals Corporation NL
SMD	Syndicated Metals Ltd
SMG	Soon Mining Limited
SMI	Santana Minerals Limited
SMIO	Santana Minerals Limited
SMLL	SMLL
SMM	Summit Resources Ltd
SMN	Structural Monitoring Systems Plc
SMP	Smartpay Holdings Limited
SMR	Stanmore Coal Limited
SNC	Sandon Capital Investments Limited
SND	Saunders International Ltd
SNL	Supply Network Ltd
SNS	Sensen Networks Limited
SNV	Sinovus Mining Ltd
SNZ	Summerset Group Holdings Limited
SO4	Salt Lake Potash Limited
SOL	Washington H Soul Pattison & Co Ltd
SOM	SomnoMed Ltd
SOP	Sml Corporation Limited
SOPOA	Synertec Corporation Limited
SOR	Strategic Elements Limited
SP3	Spectur Limited
SP3O	Spectur Limited
SPB	South Pacific Resources Limited
SPFKOC	S&p 500 Emini Futures
SPFKOD	S&p 500 Emini Futures
SPFKOF	S&p 500 Emini Futures
SPFKOH	S&p 500 Emini Futures
SPFKOI	S&p 500 Emini Futures
SPFKOJ	SPFKOJ
SPFKOQ	S&p 500 Emini Futures
SPFKOS	S&p 500 Emini Futures
SPFKOT	S&p 500 Emini Futures
SPFKOZ	S&p 500 Emini Futures
SPFMOU	SPFMOU
SPFQOA	SPFQOA
SPI	Spitfire Resources Ltd
SPK	Spark New Zealand Limited
SPL	Starpharma Holdings Ltd
SPO	Spotless Group Holdings Limited
SPQ	Superior Resources Ltd
SPQO	Superior Resources Limited
SPX	Spinifex Gold Nl
SPY	SPY
SPZ	Smart Parking Limited
SRF	Surfstitch Group Limited
SRG	Sydney Roads Group
SRH	Saferoads Holdings Ltd
SRI	Sipa Resources Ltd
SRK	Strike Resources Ltd
SRN	Surefire Resources Nl
SRNOB	Surefire Resources Nl
SRO	Shareroot Ltd
SRR	Shaw River Resources Ltd
SRS	Spicers Limited
SRV	Servcorp Ltd
SRX	Sirtex Medical Ltd
SRY	Story-i Limited
SRYO	Story-i Limited
SRZ	Stellar Resources Ltd
SRZO	Stellar Resources Limited
SSG	Shaver Shop Group Limited
SSL	Sietel Ltd
SSLPA	Sietel PA
SSM	Service Stream Ltd
SSN	Samson Oil & Gas NL
SSO	Spdr S&p/asx Small Ordinaries Fund
SST	Steamships Trading Company Ltd (PNG)
ST1	Spirit Telecom Limited
ST1O	Spirit Telecom Limited
STA	Strandline Resources Limited
STC	Stem Cell Sciences PLC
STL	Syntech Group
STLO	
STM	Sunstone Metals Ltd
STMO	Sunstone Metals Ltd
STN	Southern Titanium Nl
STO	Santos Ltd
STOKOA	Santos Limited
STOKOC	Santos Limited
STOKOD	Santos Limited
STOKOE	Santos Limited
STOKOP	Santos Limited
STOKOQ	Santos Limited
STOKOR	Santos Limited
STOKOT	Santos Limited
STOKOV	Santos Limited
STW	StreetTracks S&P/ASX 200 Fund
STX	Strike Oil Ltd
SUD	Suda Ltd
SUDR	Suda Pharmaceuticals Ltd
SUH	Southern Hemisphere Mining Limited
SUL	Super Cheap Auto Group Ltd
SULKOA	Super Retail Group Limited
SULKOC	Super Retail Group Limited
SULKOP	Super Retail Group Limited
SULKOS	Super Retail Group Limited
SUM	Sumatra Copper & Gold Plc
SUN	Suncorp-Metway Ltd
SUNBOD	Suncorp Group Limited
SUNBON	Suncorp Group Limited
SUNKOA	Suncorp Group Limited
SUNKOC	Suncorp Group Limited
SUNKOE	Suncorp Group Limited
SUNKOQ	Suncorp Group Limited
SUNKOS	Suncorp Group Limited
SUNPD	Suncorp Group Limited
SUNPE	Suncorp Group Limited
SUNPF	Suncorp Group Limited
SUNPG	Suncorp Group Limited
SUP	SuperSorb Environmental NL
SUR	Sun Resources NL
SUROA	Sun Resources Nl
SUROC	Sun Resources Nl
SVA	Simavita Limited
SVH	Silver Heritage Group Limited
SVL	Silver Mines Ltd
SVM	Sovereign Metals Ltd
SVS	Sunvest Corporation Ltd
SVT	Servtech Global Holdings Ltd
SVW	Seven Group Holdings Limited
SVWPA	Seven Group Holdings Limited
SVY	Stavely Minerals Limited
SW1	Swift Networks Group Limited
SWF	Selfwealth Limited
SWJ	Stonewall Resources Limited
SWJO	Stonewall Resources Limited
SWK	Swick Mining Services Ltd
SWM	Seven West Media Limited
SWMKOC	Seven West Media Limited
SWMKOE	Seven West Media Limited
SWMKOP	Seven West Media Limited
SWMKOR	Seven West Media Limited
SWTZ	SWTZ
SXA	Strata-x Energy Limited
SXE	Southern Cross Electrical Engineering Ltd
SXL	Southern Cross Media Group
SXLKOA	Southern Cross Media Group Limited
SXLKOB	Southern Cross Media Group Limited
SXLKOC	Southern Cross Media Group Limited
SXX	Southern Cross Exploration NL
SXY	Senex Energy Limited
SYA	Sayona Mining Limited
SYAOB	Sayona Mining Limited
SYD	Sydney Airport
SYDBOD	Sydney Airport
SYDKOA	Sydney Airport
SYDKOB	Sydney Airport
SYDKOP	Sydney Airport
SYDKOS	Sydney Airport
SYDKOT	Sydney Airport
SYI	Spdr Msci Australia Select High Dividend Yield Fund
SYIBOR	SYIBOR
SYR	Syrah Resources Ltd
SYS	Syngas Ltd
SYT	Syntonic Limited
T3D	333d Limited
TAG	Tag Pacific Ltd
TAH	Tabcorp Holdings Ltd
TAHBOA	Tabcorp Holdings Limited
TAHBOB	Tabcorp Holdings Limited
TAHBOD	Tabcorp Holdings Limited
TAHBON	Tabcorp Holdings Limited
TAHBOR	Tabcorp Holdings Limited
TAHBOU	Tabcorp Holdings Limited
TAHKOC	Tabcorp Holdings Limited
TAHKOD	Tabcorp Holdings Limited
TAHKOP	Tabcorp Holdings Limited
TAHKOS	Tabcorp Holdings Limited
TAHKOT	Tabcorp Holdings Limited
TAM	Tanami Gold NL
TAO	Tao Commodities Ltd
TAP	Tap Oil Ltd
TAR	Taruga Gold Limited
TAS	Tasman Resources NL
TAU	Trustees Australia Limited
TAW	Tawana Resources NL
TB8	Tianmei Beverage Group Corporation Limited
TBH	Topbetta Holdings Limited
TBR	Tribune Resources NL
TCL	Transurban Group
TCLKOA	Transurban Group
TCLKOD	Transurban Group
TCLKOP	Transurban Group
TCLKOQ	Transurban Group
TCN	Techniche Ltd
TCO	Transmetro Corporation Ltd
TDL	Tbg Diagnostics Limited
TDO	3D Oil Ltd
TECH	TECH
TEG	Triangle Energy (global) Limited
TEK	Thorney Technologies Ltd
TER	Terrain Australia Ltd
TEX	Target Energy Ltd
TFG	Total Face Group Limited
TFL	Tasfoods Limited
TGA	Thorn Group Limited
TGG	Templeton Global Growth Fund Ltd
TGH	Tegel Group Holdings Limited
TGN	Tungsten Mining Nl
TGO	Trimantium Growthops Limited
TGP	Trafalgar Corporate Group
TGR	Tassal Group Ltd
TGS	Tiger Resources Ltd
THC	The Hydroponics Company Limited
THCO	The Hydroponics Company Limited
THD	Thred Limited
THR	Thor Mining Plc
THX	Thundelarra Explrn Ltd (Canada CUFS)
THXOB	Thundelarra Limited
TIA	Tian An Australia Limited
TIE	Tietto Minerals Limited
TIG	Tigers Realm Coal Limited
TIN	Tnt Mines Limited
TKF	Tikforce Limited
TKL	Traka Resources Ltd
TKM	Trek Metals Limited
TLG	Talga Gold Limited
TLGOA	Talga Resources Ltd
TLM	Talisman Mining Ltd
TLS	Telstra Corporation Ltd
TLSBOA	Telstra Corporation Limited.
TLSBOD	Telstra Corporation Limited.
TLSBOE	Telstra Corporation Limited.
TLSBOF	Telstra Corporation Limited.
TLSBOG	Telstra Corporation Limited.
TLSBON	Telstra Corporation Limited.
TLSBOP	Telstra Corporation Limited.
TLSBOT	Telstra Corporation Limited.
TLSBOU	Telstra Corporation Limited.
TLSKOB	Telstra Corporation Limited.
TLSKOC	Telstra Corporation Limited.
TLSKOD	Telstra Corporation Limited.
TLSKOG	Telstra Corporation Limited.
TLSKOJ	Telstra Corporation Limited.
TLSKOL	Telstra Corporation Limited.
TLSKOM	Telstra Corporation Limited.
TLSKOQ	Telstra Corporation Limited.
TLSKOR	Telstra Corporation Limited.
TLSKOS	Telstra Corporation Limited.
TLSKOT	Telstra Corporation Limited.
TLSKOU	Telstra Corporation Limited.
TLSKOV	Telstra Corporation Limited.
TLSKOW	Telstra Corporation Limited.
TLSLOA	Telstra Corporation Limited.
TLSLOD	Telstra Corporation Limited.
TLSLOG	Telstra Corporation Limited.
TLSLOH	Telstra Corporation Limited.
TLSLOP	Telstra Corporation Limited.
TLSLOQ	Telstra Corporation Limited.
TLSLOR	Telstra Corporation Limited.
TLSLOS	Telstra Corporation Limited.
TLSLOU	Telstra Corporation Limited.
TLSLOV	Telstra Corporation Limited.
TLSQOQ	Telstra Corporation Limited.
TLT	Tourism & Leisure Trust
TLX	Telix Pharmaceuticals Limited
TME	Trade Me Group Limited
TMEKOB	Trade Me Group Limited
TMEKOC	Trade Me Group Limited
TMK	Tamaska Oil And Gas Ltd
TML	Timah Resources Limited
TMP	Tech Mpire Limited
TMT	Tyndall Meridian Trust
TMTO	Technology Metals Australia Limited
TMX	Terrain Minerals Ltd
TMZ	Thomson Resources Limited
TNE	Technology One Ltd
TNEKOA	Technology One Limited
TNEKOB	Technology One Limited
TNG	Tennant Creek Gold Ltd
TNK	Think Childcare And Education Limited
TNO	Tando Resources Limited
TNOO	Tando Resources Limited
TNP	Tango Petroleum Limited
TNR	Torian Resources Nl
TNT	Tesserent Limited
TNY	Tennyson Networks Holdings
TOE	Toro Energy Ltd
TOM	Tomizone Ltd
TOMO	Tomizone Limited
TON	Triton Gold Limited
TONOB	Triton Minerals Ltd
TONOC	Triton Minerals Ltd
TOP	Thorney Opportunities Ltd
TOT	360 Capital Total Return Fund
TOU	Tlou Energy Limited
TPC	Tel Pacific Ltd
TPD	Talon Petroleum Limited
TPE	Tpi Enterprises Limited
TPM	Tpg Telecom Limited
TPMKOA	Tpg Telecom Limited
TPMKOC	Tpg Telecom Limited
TPMKOD	Tpg Telecom Limited
TPO	Tian Poh Resources Limited
TPP	Tempo Australia Ltd
TPS	Threat Protect Australia Limited
TPW	Temple & Webster Group Ltd
TRA	Turners Automotive Group Limited
TRL	Tanga Resources Limited
TRM	Truscott Mining Corporation Ltd
TRS	Reject Shop Ltd (The)
TRSKOQ	The Reject Shop Limited
TRT	Tuart Resources
TRTO	Todd River Resources Limited
TRY	Troy Resources NL
TSN	TSN
TTA	TTA Holdings Ltd
TTC	Traditional Therapy Clinics Limited
TTI	Traffic Technologies Ltd
TTL	Thin Technologies
TTLO	Transcendence Technologies Limited
TTM	Titan Minerals Limited
TTSHA	Tatts Group Limited
TTT	Tritton Resources Ltd
TTW	Toptung Ltd
TV2	Tv2u International Limited
TV2O	Tv2u International Limited
TWD	Tamawood Ltd
TWE	Treasury Wine Estates Limited
TWEKOB	Treasury Wine Estates Limited
TWEKOC	Treasury Wine Estates Limited
TWEKOR	Treasury Wine Estates Limited
TWR	Tower Ltd
TYK	Tychean Resources Ltd
TYX	Tyranna Resources Limited
TYXOC	Tyranna Resources Limited
TZL	TZ Ltd
TZN	Terramin Australia Ltd
UBA	UBA
UBE	UBE
UBI	Universal Biosensors Ltd
UBJ	UBJ
UBN	Urbanise.com Limited
UBP	UBP
UBU	UBU
UBW	UBW
UCM	USCOM Ltd
UCW	Undercoverwear Ltd
UIL	Uil Energy Ltd
UNL	United Networks Limited
UNV	Universal Coal Plc
UOS	United Overseas Australia Ltd
UPD	Updater Inc
URB	Urb Investments Limited
URF	Us Masters Residential Property Fund
URFHA	Us Masters Residential Property Fund
URFHB	Us Masters Residential Property Fund
URFHC	Us Masters Residential Property Fund
URFPA	Us Masters Residential Property Fund
URW	Unibail-rodamco-westfield
USA	Uraniumsa Ltd
USD	Betashares U.s. Dollar Etf
USR	Us Residential Fund
UTR	Ultracharge Limited
UUL	United Uranium Ltd
UUV	Uuv Aquabotix Ltd
UUVO	Uuv Aquabotix Ltd
VACF	VACF
VAE	VAE
VAF	VAF
VAH	Virgin Australia Holdings Limited
VAL	Valor Resources Limited
VALOA	Valor Resources Limited
VAN	Vango Mining Limited
VANOB	Vango Mining Limited
VAP	Vanguard Australian Property Securities Index Etf
VAR	Variscan Mines Limited
VAROA	Variscan Mines Limited
VAS	VAS
VASBOR	VASBOR
VBS	Vectus Biosystems Limited
VCF	VCF
VCX	Vicinity Centres
VCXKOB	Vicinity Centres
VCXKOC	Vicinity Centres
VCXKOD	Vicinity Centres
VDBA	VDBA
VDCO	VDCO
VDGR	VDGR
VDHG	VDHG
VEA	Veda Advantage Ltd
VEC	Vector Capital Ltd
VEE	Veem Ltd
VELCP	Vealls CP
VELPA	Vealls PA
VEQ	VEQ
VEU	VEU
VG1	Vgi Partners Global Investments Limited
VGB	Vanguard Australian Government Bond Index Etf
VGE	VGE
VGL	Volante Group Ltd
VGS	VGS
VHT	Volpara Health Technologies Limited
VHY	Vanguard Australian Shares High Yield Etf
VHYBOB	VHYBOB
VHYBOF	VHYBOF
VHYBOG	VHYBOG
VHYBOM	VHYBOM
VHYBON	VHYBON
VHYBOR	VHYBOR
VIA	ViaGold Capital Ltd
VIC	Victory Mines Limited
VICOA	Victory Mines Limited
VIF	VIF
VIG	Victor Group Holdings Limited
VII	Vietnam Industrial Investments Ltd
VIP	Voltage IP Ltd
VIV	Vivid Technology Limited
VKA	Viking Ashanti Limited
VLC	Vanguard Msci Australian Large Companies Index Etf
VLS	Vita Life Sciences
VLT	Vault Intelligence Limited
VLW	Villa World Group
VLWHA	Villa World Limited.
VMC	Venus Metals Corporation Limited
VMCOA	Venus Metals Corporation Limited
VMG	VDM Group Ltd
VMIN	VMIN
VML	Vital Metals Ltd
VMS	Venture Minerals Ltd
VMT	Vmoto Ltd
VMX	Valmec Limited
VMY	Vimy Resources Limited
VN8	Vonex Limited..
VN8O	Vonex Limited..
VOC	Vocus Communications Limited
VOCKOB	Vocus Communications Limited
VOCKOC	Vocus Communications Limited
VOCKOD	Vocus Communications Limited
VOCKOE	Vocus Communications Limited
VOCKOQ	Vocus Communications Limited
VOCKOR	Vocus Group Limited
VP7	Velocity Property Group Limited
VPC	Velpic Limited
VPCOA	Velpic Limited
VPR	Volt Power Group Limited
VRC	Volt Resources Limited
VRI	VRI BioMedical Ltd
VRL	Village Roadshow Ltd
VRM	Verdant Minerals Ltd
VRS	Veris Limited
VRT	Virtus Health Limited
VRTKOA	Virtus Health Limited
VRTKOD	Virtus Health Limited
VRTKOP	Virtus Health Limited
VRTKOQ	Virtus Health Limited
VRTKOS	Virtus Health Limited
VRX	Ventnor Resources Ltd
VSO	Vanguard Msci Australian Small Companies Index Etf
VTG	Vita Group Ltd
VTI	Virotec International Ltd
VTS	VTS
VVLU	VVLU
VVR	Viva Energy Reit
VXR	
VYS	Vysarn Limited
WAA	Wam Active Ltd
WAAO	Wam Active Ltd
WAF	West African Resources Limited
WAL	Wavenet International Ltd
WAM	WAM Capital Ltd
WAT	Waterco Ltd
WAX	WAX
WBA	Webster Ltd
WBAPA	Webster PA
WBC	Westpac Banking Corporation
WBCBOA	Westpac Banking Corporation
WBCBOB	Westpac Banking Corporation
WBCBOD	Westpac Banking Corporation
WBCBOF	Westpac Banking Corporation
WBCBON	Westpac Banking Corporation
WBCBOQ	Westpac Banking Corporation
WBCBOR	Westpac Banking Corporation
WBCHB	Westpac Banking Corporation
WBCKOA	Westpac Banking Corporation
WBCKOD	Westpac Banking Corporation
WBCKOF	Westpac Banking Corporation
WBCKOH	Westpac Banking Corporation
WBCKOI	Westpac Banking Corporation
WBCKOL	Westpac Banking Corporation
WBCKOP	Westpac Banking Corporation
WBCKOS	Westpac Banking Corporation
WBCKOU	Westpac Banking Corporation
WBCKOX	Westpac Banking Corporation
WBCKOZ	Westpac Banking Corporation
WBCLOA	Westpac Banking Corporation
WBCLOB	Westpac Banking Corporation
WBCLOD	Westpac Banking Corporation
WBCLOE	Westpac Banking Corporation
WBCLOF	Westpac Banking Corporation
WBCLOP	Westpac Banking Corporation
WBCLOR	Westpac Banking Corporation
WBCLOS	Westpac Banking Corporation
WBCLOT	Westpac Banking Corporation
WBCLOU	Westpac Banking Corporation
WBCMOB	Westpac Banking Corporation
WBCMOP	Westpac Banking Corporation
WBCMOQ	Westpac Banking Corporation
WBCMOS	Westpac Banking Corporation
WBCPD	Westpac Banking Corporation
WBCPE	Westpac Banking Corporation
WBCPF	Westpac Banking Corporation
WBCPG	Westpac Banking Corporation
WBCPH	Westpac Banking Corporation
WBCQOA	Westpac Banking Corporation
WBE	Whitebark Energy Ltd
WBT	Weebit Nano Ltd
WCN	White Cliff Nickel Ltd
WCNOB	White Cliff Minerals Limited
WCNOC	White Cliff Minerals Limited
WDE	Wealth Defender Equities Limited
WDMF	WDMF
WEB	Webjet Ltd
WEBKOC	Webjet Limited
WEBKOD	Webjet Limited
WEC	White Energy Company Ltd
WEL	Winchester Energy Ltd
WEMG	WEMG
WES	Wesfarmers Ltd
WESBON	Wesfarmers Limited
WESKOA	Wesfarmers Limited
WESKOC	Wesfarmers Limited
WESKOF	Wesfarmers Limited
WESKOG	Wesfarmers Limited
WESKOH	Wesfarmers Limited
WESKOQ	Wesfarmers Limited
WESKOS	Wesfarmers Limited
WESKOT	Wesfarmers Limited
WESKOW	Wesfarmers Limited
WESLOA	Wesfarmers Limited
WESLOB	Wesfarmers Limited
WESLOC	Wesfarmers Limited
WESLOD	Wesfarmers Limited
WESLOE	Wesfarmers Limited
WESLOP	Wesfarmers Limited
WESLOQ	Wesfarmers Limited
WESLOR	Wesfarmers Limited
WESLOS	Wesfarmers Limited
WFE	Winmar Resources Limited
WGB	Wam Global Limited
WGF	Watermark Global Leaders Fund Limited
WGFO	Watermark Global Leaders Fund Limited
WGL	Wangle Technologies Limited
WGN	Wagners Holding Company Limited
WGX	Westgold Resources Limited.
WGXO	Westgold Resources Limited.
WHA	Wattle Health Australia Limited
WHC	Whitehaven Coal Ltd
WHCKOA	Whitehaven Coal Limited
WHCKOB	Whitehaven Coal Limited
WHCKOC	Whitehaven Coal Limited
WHCKOD	Whitehaven Coal Limited
WHCKOF	Whitehaven Coal Limited
WHCKOQ	Whitehaven Coal Limited
WHCKOS	Whitehaven Coal Limited
WHCKOW	Whitehaven Coal Limited
WHCKOY	Whitehaven Coal Limited
WHF	Whitefield Ltd
WHFPA	Whitefield PA
WHFPB	Whitefield Limited
WHK	Whitehawk Limited
WIC	Westoz Investment Company Limited
WICOC	Westoz Investment Company Limited
WKT	Walkabout Resources Ltd
WKTOA	Walkabout Resources Ltd
WLC	Wollongong Coal Limited
WLD	Wellard Limited
WLE	Wam Leaders Limited
WLF	Wolf Minerals Ltd
WLL	Wellcom Group Ltd
WMC	Wonhe Multimedia Commerce Ltd
WMI	Wam Microcap Limited
WMK	Watermark Market Neutral Fund Limited
WML	Westcoast Mining Ltd
WND	Windlab Limited
WNR	Wingara Ag Ltd
WNS	World.Net Services Ltd
WOA	Wide Open Agriculture Ltd
WOF	Wolf Petroleum Ltd
WOFOA	Wolf Petroleum Ltd
WOR	WorleyParsons Ltd
WORKOA	Worleyparsons Limited
WORKOB	Worleyparsons Limited
WORKOD	Worleyparsons Limited
WORKOS	Worleyparsons Limited
WORKOV	Worleyparsons Limited
WOW	Woolworths Ltd
WOWBON	Woolworths Limited
WOWBOR	Woolworths Limited
WOWKOC	Woolworths Limited
WOWKOF	Woolworths Limited
WOWKOG	Woolworths Limited
WOWKOS	Woolworths Limited
WOWKOU	Woolworths Limited
WOWKOV	Woolworths Limited
WPG	Western Plains Gold Ltd
WPL	Woodside Petroleum Ltd
WPLBOA	Woodside Petroleum Limited
WPLBOB	Woodside Petroleum Limited
WPLBON	Woodside Petroleum Limited
WPLBOR	Woodside Petroleum Limited
WPLKOB	Woodside Petroleum Limited
WPLKOC	Woodside Petroleum Limited
WPLKOD	Woodside Petroleum Limited
WPLKOE	Woodside Petroleum Limited
WPLKOG	Woodside Petroleum Limited
WPLKOJ	Woodside Petroleum Limited
WPLKOK	Woodside Petroleum Limited
WPLKOL	Woodside Petroleum Limited
WPLKOP	Woodside Petroleum Limited
WPLKOQ	Woodside Petroleum Limited
WPLKOS	Woodside Petroleum Limited
WPLKOU	Woodside Petroleum Limited
WPLKOV	Woodside Petroleum Limited
WPLKOW	Woodside Petroleum Limited
WPLKOX	Woodside Petroleum Limited
WPLLOA	Woodside Petroleum Limited
WPLLOE	Woodside Petroleum Limited
WPLLOF	Woodside Petroleum Limited
WPLLOG	Woodside Petroleum Limited
WPLLOP	Woodside Petroleum Limited
WPLLOQ	Woodside Petroleum Limited
WPLLOT	Woodside Petroleum Limited
WPLLOU	Woodside Petroleum Limited
WPLLOV	Woodside Petroleum Limited
WPLQOP	Woodside Petroleum Limited
WPP	Wpp Aunz Ltd
WQG	Wcm Global Growth Limited
WQGO	Wcm Global Growth Limited
WQW	Winha Commerce And Trade Intl Limited
WRM	White Rock Minerals Limited
WRR	World Reach Ltd
WSA	Western Areas NL
WSAKOA	Western Areas Nl
WSAKOP	Western Areas Nl
WSAKOR	Western Areas Limited
WSI	Weststar Industrial Limited
WSIO	Weststar Industrial Limited
WTC	Wisetech Global Limited
WTCKOB	Wisetech Global Limited
WTCKOC	Wisetech Global Limited
WTCKOD	Wisetech Global Limited
WTP	Watpac Ltd
WVOL	WVOL
WWI	West Wits Mining Ltd
WXHG	WXHG
WXOZ	SPDR S&P World Ex Australia Fund
WZR	Wisr Limited
XAE	
XAF	S&P/ASX All Australian 50
XAM	Xanadu Mines Limited
XAO	ASX All Ordinaries
XAT	S&P/ASX All Australian 200
XBW	S&P/ASX Buy-Write Index
XDI	
XDJ	S&P/ASX 200 Consumer Discretionary
XEC	
XEJ	S&P/ASX 200 Energy
XF1	Xref Limited
XFD	
XFJ	S&P/ASX 200 Financials
XFL	S&P/ASX 50
XFT	
XGD	S&P/ASX All Ordinaries Gold
XHJ	S&P/ASX 200 Health Care
XIJ	S&P/ASX 200 Information Technology
XIP	Xenith Ip Group Limited
XJO	S&P/ASX 200
XJOBOK	XJOBOK
XJOBOL	XJOBOL
XJOBOM	XJOBOM
XJOKOB	XJOKOB
XJOKOC	XJOKOC
XJOKOD	XJOKOD
XJOKOE	XJOKOE
XJOKOF	XJOKOF
XJOKOG	XJOKOG
XJOKOH	XJOKOH
XJOKOI	XJOKOI
XJOKOJ	XJOKOJ
XJOKOL	XJOKOL
XJOKOM	XJOKOM
XJOKON	XJOKON
XJOKOR	XJOKOR
XJOKOS	XJOKOS
XJOKOT	XJOKOT
XJOKOU	XJOKOU
XJOKOV	XJOKOV
XJOLOA	XJOLOA
XJOLOB	XJOLOB
XJOLOC	XJOLOC
XJOLOH	XJOLOH
XJOLOI	XJOLOI
XJOLOJ	XJOLOJ
XJOLOK	XJOLOK
XJOLOL	XJOLOL
XJOLOP	XJOLOP
XJOLOQ	XJOLOQ
XJOLOU	XJOLOU
XJOLOW	XJOLOW
XJOLOZ	XJOLOZ
XJOMOB	XJOMOB
XJOMOC	XJOMOC
XJOMOG	XJOMOG
XJOMOH	XJOMOH
XJOMOI	XJOMOI
XJOMOJ	XJOMOJ
XJOMOK	XJOMOK
XJOMOL	XJOMOL
XJOMOM	XJOMOM
XJOMOP	XJOMOP
XJOMOW	XJOMOW
XJOMOX	XJOMOX
XJOQOE	XJOQOE
XJOQOP	XJOQOP
XJOQOR	XJOQOR
XJOQOT	XJOQOT
XJOQOU	XJOQOU
XJR	
XKO	S&P/ASX 300
XLD	
XMD	S&P/ASX Midcap 50
XMJ	S&P/ASX 200 Materials
XMM	S&P/ASX 300 Metals And Mining
XNJ	S&P/ASX 200 Industrials
XNT	
XNV	
XPD	Xpd Soccer Gear Group Limited
XPE	Xped Limited
XPEOC	Xped Limited
XPJ	S&P/ASX 200 Property Trusts
XRF	XRF Scientific Ltd
XRO	Xero Limited
XROKOA	Xero Limited
XSJ	S&P/ASX 200 Consumer Staples
XSO	S&P/ASX Small Ordinaries
XST	Xstate Resources Ltd
XSY	
XTD	Xtd Ltd
XTE	ASX Telecommunications
XTJ	S&P/ASX 200 Telecommunication Services
XTL	S&P/ASX 20
XTO	S&P/ASX 100
XTV	Xtv Networks Ltd
XUJ	S&P/ASX 200 Utilities
XVI	
XXJ	S&P/ASX 200 Financials x Property Trusts
YAL	Yancoal Australia Limited
YANK	YANK
YBR	Yellow Brick Road Holdings Limited
YOJ	Yojee Limited
YOW	Yowie Group Ltd
YPB	Ypb Group Ltd
YTMAGL	YTMAGL
YTMANZ	YTMANZ
YTMAP1	YTMAP1
YTMAPA	YTMAPA
YTMAST	YTMAST
YTMAWC	YTMAWC
YTMAZJ	YTMAZJ
YTMBH1	YTMBH1
YTMCCA	YTMCCA
YTMCTX	YTMCTX
YTMF04	YTMF04
YTMF05	YTMF05
YTMF06	YTMF06
YTMF07	YTMF07
YTMF08	YTMF08
YTMF09	YTMF09
YTMF10	YTMF10
YTMF11	YTMF11
YTMGP1	YTMGP1
YTMGPT	YTMGPT
YTMLL1	YTMLL1
YTMLLC	YTMLLC
YTMMG2	YTMMG2
YTMMGR	YTMMGR
YTMMQG	YTMMQG
YTMNA1	YTMNA1
YTMNAB	YTMNAB
YTMQF1	YTMQF1
YTMQF2	YTMQF2
YTMQF3	YTMQF3
YTMTCL	YTMTCL
YTMTL1	YTMTL1
YTMTLS	YTMTLS
Z1P	Zip Co Limited.
ZAM	Zamanco Minerals Limited
ZCLKOC	ZCLKOC
ZCLKOD	ZCLKOD
ZCLKOE	ZCLKOE
ZCLKOF	ZCLKOF
ZCLKOG	ZCLKOG
ZCLKOP	ZCLKOP
ZCLKOV	ZCLKOV
ZCLKOW	ZCLKOW
ZCLKOX	ZCLKOX
ZCLKOZ	ZCLKOZ
ZCLMOS	ZCLMOS
ZCNH	ZCNH
ZEL	Zeolite Australia
ZEN	Zenith Energy Limited
ZER	Zeta Resources Limited
ZEU	Zeus Resources Limited
ZGCKOC	ZGCKOC
ZGCKOD	ZGCKOD
ZGCKOG	ZGCKOG
ZGCKOH	ZGCKOH
ZGCKOP	ZGCKOP
ZGCKOQ	ZGCKOQ
ZGCKOR	ZGCKOR
ZGCKOS	ZGCKOS
ZGCKOT	ZGCKOT
ZGCKOU	ZGCKOU
ZGL	Zicom Group Ltd
ZGM	Zamia Gold Mines Ltd
ZGOL	ZGOL
ZHGKOB	ZHGKOB
ZHGKOD	ZHGKOD
ZHGKOG	ZHGKOG
ZHGKOH	ZHGKOH
ZHGKOS	ZHGKOS
ZHGKOX	ZHGKOX
ZIM	Zimbabwe Platinum Mines Ltd
ZIP	Ziptel Limited
ZIPOB	Ziptel Limited
ZLD	Zelda Therapeutics Limited
ZMI	Zinc Of Ireland Nl
ZMIOC	Zinc Of Ireland Nl
ZNC	Zinc Co Australia Ltd
ZNO	Zoono Group Limited
ZNT	Zenitas Healthcare Limited
ZSIKOA	ZSIKOA
ZSIKOB	ZSIKOB
ZSIKOC	ZSIKOC
ZSIKOF	ZSIKOF
ZSIKOG	ZSIKOG
ZSIKOQ	ZSIKOQ
ZSIKOR	ZSIKOR
ZSIKOT	ZSIKOT
ZSIKOU	ZSIKOU
ZTA	Zeta Petroleum Plc
ZYAU	ZYAU
ZYB	Zyber Holdings Ltd
ZYBOA	Zyber Holdings Ltd
