Symbol	Description
A	Armor Minerals Inc
AA	Alba Minerals Inc
AAD	Added Capital Inc
AAG.H	Aftermath Silver Ltd
AAL	Advantage Lithium Corp
AAN	Aton Resources Inc
AAO	Augusta Industries Inc
AAP	Alpha Peak Leisure Inc
AAX	Advance Gold Corp
AAZ	Azincourt Energy Corp.
AB.H	Asbestos Corporation Limited
ABCN	Abcann Global Corp
ABI	Abcourt Mines Inc
ABM	Athabasca Minerals Inc
ABN	Aben Resources Ltd
ABRA	Abraplata Resource Corp
ABZ	Asiabasemetals Inc
ACP	Arcpacific Resources Corp
ACST	Acasti Pharma Inc
ACU	Aurora Solar Technologies Inc
ADD	Arctic Star Exploration Corp
ADE	Adex Mining Inc
ADG	Arcus Development Group Inc
ADK	Diagnos Inc
ADYA	Adya Inc
ADZ	Adamera Minerals Corp
ADZN	Adventus Zinc Corp
AEC	Anfield Energy Inc.
AEL.H	Amseco Exploration Ltd
AEP	Atlas Engineered Products Ltd.
AET	Aethon Minerals Corporation
AEX	Aex Gold Inc.
AFCC	Automotive Finco Corp
AFCC.DB	Automotive Finco Corp 6.75 Pct Debs
AFE	Africa Energy Corp
AFF	Affinity Metals Corp
AFM	Alphamin Resources Corp
AGB	Atlantic Gold Corp
AGB.WT	Atlantic Gold Corp Wts
AGC	Amarillo Gold Corp
AGD	Antioquia Gold Inc
AGG	African Gold Group Inc
AGH.H	Canadian Silver Hunter Inc
AGLD	Austral Gold Limited
AGM	Aldridge Minerals Inc
AGO	Aurcrest Gold Inc
AGRL	Aguia Resources Limited
AGZ	Ashanti Gold Corp
AHE	American Helium Inc.
AHI	Agility Health Inc
AHM.H	Antler Hill Mining Ltd
AHR	Amarc Resources Ltd
AHS	Alta Natural Herbs and S
AHU	Arctic Hunter Energy Inc
AIII.P	Apolo III Acquisition Corp
AIIM	Albert Mining Inc
AIS	Ais Resources Limited
AKH	Alaska Hydro Corp
AKR	Ackroo Inc
AL	Alx Uranium Corp
ALD	Aldever Resources Inc
ALEF	Aleafia Health Inc.
ALG	Algold Resources Ltd
ALL.H	Allante Resources Ltd
ALM	Alliance Mining Corp
ALT	Alturas Minerals Corp
ALTA	Altamira Gold Corp
ALTS	Altus Strategies Plc
ALV	Alvopetro Energy Ltd
ALY	Analytixinsight Inc
ALZ	Aldershot Resources Ltd
AME	Abacus Mining and Exploration
AMK	American Creek Resources Ltd
AMO	Altan Rio Minerals Limited
AMR	Am Resources Corp
AMX	AMEX Exploration Inc
AMY	American Manganese Inc
AMZ	Azucar Minerals Ltd.
AN	Arena Minerals Inc
ANC.H	Anchor Capital Corporation
ANE	Altan Nevada Minerals Limited
ANG	Angel Gold Corp
ANK	Angkor Gold Corp
ANL.H	Atlantic Industrial Minerals Inc
ANTL	Antler Gold Inc
ANZ	Alianza Minerals Ltd
AORO	Aloro Mining Corp
AOT	Ascot Resources Ltd
APC	Advanced Proteome Therapeutics Corp
APII.P	Apolo II Acquisition Corp
APN	Altiplano Minerals Ltd
APX	Apex Resources Inc
AQS	Aequus Pharmaceuticals Inc
ARA	Anconia Resources Corp
ARCH	Arch Biopartners Inc
ARD	Armada Data Corp
ARH	Altima Resources Ltd
ARIC	Awale Resources Ltd.
ART	Arht Media Inc
ARU	Aurania Resources Ltd
ASB.H	Asb Capital Inc
ASG	Aurora Spine Corp
ASI	Ashanti Sankofa Inc
ASL	Argentum Silver Corp
ASN	Asian Mineral Res Ltd
ASQ	Astorius Resources Ltd
AT	Acuityads Holdings Inc
ATC	Atac Resources Ltd
ATE	Antibe Therapeutics Inc
ATG	Atlanta Gold Inc
ATI	Altai Resources Inc
ATM	Atacama Pacific Gold Corp
ATU	Altura Energy Inc
ATV	Alto Ventures Ltd
ATW	Atw Tech Inc.
ATY	Atico Mining Corp
AU	Aurion Resources Ltd
AUAU	Allegiant Gold Ltd
AUL	Aurelius Minerals Inc
AUN	Aurcana Corp
AUOC.P	Aumento Capital Vii Corporation
AUR.H	Aurora Royalties Inc
AUT	Austin Resources Ltd
AUU	Aura Silver Resources Inc
AUX	Auramex Resource Corp
AVG	Avidian Gold Corp
AVN	Avanti Energy Inc
AVU	Avrupa Minerals Ltd
AVX	Altair Resources Inc
AWE	Thunderstruck Resources Ltd
AWI	Advent Awi Holdings Inc
AXE	Acceleware Ltd
AXIS	Axis Auto Finance Inc
AXM	Axmin Inc
AXQ	Axe Exploration Inc
AXV	Axion Ventures Inc
AZM	Azimut Exploration Inc
AZN.H	Arcturus Ventures Inc
AZR	Azarga Metals Corp
AZS	Arizona Silver Exploration Inc
AZT	Aztec Minerals Corp
AZX	Alexandria Minerals Corp
B	Bcm Resources Corp
BAL.H	Balto Resources Ltd
BANC	Bankers Cobalt Corp.
BAT	Batero Gold Corp
BATT	Bluebird Battery Metals Inc.
BAV.H	Bravern Ventures Ltd
BAY	Aston Bay Holdings Ltd
BBB	Brixton Metals Corp
BBI	Blackbird Energy Inc
BBI.WT	Blackbird Energy Inc Wts
BCF	Builders Capital Mortgage Corp
BCK	Blind Creek Resources Ltd
BCM	Bear Creek Mining Corp
BCP	Broome Capital Corp
BCT	Briacell Therapeutics Corp
BCU	Bell Copper Corporation
BDG	Black Dragon Gold Corp
BEA	Belmont Resources Inc
BEAN	Peekaboo Beans Inc
BEE	Bee Vectoring Technologies Intl Inc
BEN.H	Butte Energy Inc
BER	BE Resources Inc
BEW	Bewhere Holdings Inc
BEX	Benton Resources Inc
BFD	Beaufield Resources Inc
BFF	Nevada Energy Metals Inc
BGA	Bioneutra Global Corp
BGG	Buccaneer Gold Corp
BGM	Barkerville Gold Mines Ltd
BGS	Baroyeca Gold and Silver Inc
BHR	Blackheath Resources Inc
BHS	Bayhorse Silver Inc
BHT	Braveheart Resources Inc
BIT	Black Isle Resources Corp
BITK	Blockchaink2 Corp
BKD	Breaking Data Corp
BKM	Pacific Booker Minerals Inc
BKR	Berkwood Resources Ltd
BLM	Blumetric Environmental Inc
BLN	Blackline Safety Corp
BLOK	Block One Capital Inc.
BLR	Blackhawk Resource Corp
BLS	Black Sea Copper and Gold Corp
BM.H	Bc Moly Ltd
BME	Barsele Minerals Corp
BMK	Macdonald Mines Expl Ltd
BML	Barker Minerals Ltd
BMM	Black Mammoth Metals Corp
BMX	Boreal Metals Corp
BMX.WT	Boreal Metals Corp Wts
BNCH	Benchmark Metals Inc.
BOL	Bold Ventures Inc
BOR	Border Petroleum Limited
BP	Backstageplay Inc
BP.H	Backstageplay Inc
BPLI	Bluedrop Performance Learning Inc
BPWR.UN	Blockchain Power Trust
BQE	Bqe Water Inc
BRC	Blackrock Gold Corp
BRD	Broadway Gold Mining Ltd
BRG.H	Brigadier Gold Limited
BRL	Bearclaw Capital Corp
BRM	Biorem Inc
BRN.PR.A	Brookfield Investments Corp Pref A
BRO	Barksdale Capital Corp
BRS	Brs Resources Ltd
BRZ	Bearing Lithium Corp
BSK	Blue Sky Uranium Corp
BSR	Bluestone Resources Inc
BTI	Bioasis Technologies Inc
BTL	Btl Group Ltd
BTR	Bonterra Resources Inc
BTRU	Betteru Education Corp
BTT	Bitterroot Resources Ltd
BTU	Btu Metals Corp
BTV	Bluerush Inc.
BUD	Satori Resources Inc
BUF	Buffalo Coal Corp
BUL	Bullman Minerals Inc
BUS	Grande West Transportation Group Inc
BUZD.P	High Mountain Capital Corporation
BVA	Bravada Gold Corp
BVO	Bevo Agro Inc
BWLK	Boardwalktech Software Corp
BWR	Bwr Exploration Inc
BXR	Blue River Resources Ltd
BYM.H	Baymount Incorporated
BYN	Banyan Gold Corp
BZ	Benz Mining Corp
C	Contact Gold Inc
CA.H	Catalina Gold Corp
CAB.P	Cabernet Captial Corp
CAD	Colonial Coal International Corp
CAF	Canaf Group Inc
CANB.P	Canadabis Capital Inc
CAND	Candelaria Mining Corp
CANX	Canex Metals Inc
CAP	Castle Peak Mining Ltd
CAQ.P	Commerce Acquisition Corp
CASA	Casa Minerals Inc
CAV	Camrova Resources Inc
CAY	Cache Exploration Inc
CBA	Champion Bear Res Ltd
CBE	Cabo Drilling Corp
CBG	Chibougamau Independent Mines Inc
CBI	Colibri Resource Corp
CBLT	Cblt Inc
CBLU	Clear Blue Technologies Intl Inc
CBM.H	Cbd Med Research Corp
CBR	Cabr Al Gold Inc
CBS	Bard Ventures Ltd
CBV	Cobra Venture Corp
CBX	Cortex Business Solutions Inc
CCB	Canada Carbon Inc
CCC	Cornerstone Metals Inc
CCD	Cascadero Copper Corp
CCE	Commerce Resources Corp
CCK	Canada Coal Inc
CCW	Canada Cobalt Works Inc.
CD	Cantex Mine Development Corp
CDA	Canuc Resources Corp
CDB	Cordoba Minerals Corp
CDC	Cadillac Ventures Inc
CDG	Candente Gold Corp
CDU	Cardero Resource Corp
CE	Canada Energy Partners Inc
CEL.H	Columbus Energy Limited
CEM	Constantine Metal Resources Ltd
CEN	Claren Energy Corp
CEO.H	Clydesdale Resources Inc.
CEP	Cliffside Capital Ltd
CFM	Confederation Minerals Ltd
CFY	Changfeng Energy Inc
CGD	Carlin Gold Corp
CGLD	Core Gold Inc.
CGM	California Gold Mining Inc
CGP	Cornerstone Capital Resources Inc
CGP.WT.S	Cornerstone Capital Res Inc Wts
CH	Urban Select Captial Corp
CHC	Chc Student Housing Corp
CHEM	Canadian Energy Materials Corp.
CHN	China Education Resources Inc
CIFR	Cipher Resources Inc.
CIO	Central Iron Ore Limited
CIP.H	Canadian International Pharma Corp
CIT	Cr Capital Corp
CJC	Quebec Precious Metals Corp.
CKG	Chesapeake Gold Corp
CKK	Cordy Oilfield Services Inc
CKZ.H	Caspian Energy Inc
CLB	Colombia Crest Gold Corp
CLE	Clean Commodities Corp
CLH	Coral Gold Resources Ltd
CLI	Clearford Water Systems Inc
CLM	Crystal Lake Mining Corp
CLY	Clarocity Corp
CLZ	Canasil Resources Inc
CMB	Cmc Metals Ltd
CMD	Commander Resources Ltd
CMI	C-Com Satellite Systems Inc
CML	Canickel Mining Limited
CMU	Comet Industries Ltd
CMV	China Minerals Mining Corp
CMX	Chilean Metals Inc
CN	Condor Resources Inc
CNA.H	Canasia Financial Inc
CNC	Canyon Copper Corp
CNH	Crownia Holdings Ltd
CNO	California Nanotechnologies Corp
CNS	Contagious Gaming Inc
CNX	Callinex Mines Inc
COBC	Cobalt Blockchain Inc.
COIN	Malbex Resources Inc
COL	Copper North Mining Corp
CONE	Canada One Mining Corp
COO	Naturebank Asset Management Inc
COPS	Crops Inc.
COR	Camino Minerals Corp
CORE	Canadian Orebodies Inc
COT	Cotinga Pharmaceuticals Inc.
COV	Covalon Technologies Ltd
CPA.H	Chinapintza Mining Corp
CPC	Canadian Platinum Corp
CPL	Copper Lake Resources Ltd
CPM	Crystal Peak Minerals Inc
CPO	Cobalt Power Group Inc
CPQ.P	Cinaport Acquisition Corp II
CPS	Claim Post Resources Inc
CPTO	Cryptoglobal Corp.
CQR	Conquest Resources Ltd
CQV.H	Canadian Imperial Venture Corp
CRB	Cariboo Rose Resources Ltd
CRD.H	Coronado Resources Ltd
CRE	Critical Elements Corp
CRU	Cameo Cobalt Corp.
CRX.H	Cerro Mining Corp
CSC.H	Canex Energy Corp
CSL	Comstock Metals Ltd
CSO	Corsa Coal Corp
CST	Co2 Solutions Inc
CSX	Clean Seed Capital Group Ltd
CT	Centenara Mining Corp
CTI	Caiterra International E
CTM	Canterra Minerals Corp
CTN	Centurion Minerals Ltd
CTO	Circa Enterprises Inc
CTU	Le Chateau Inc Cl B
CTZ	Namsys Inc
CUC	Carube Copper Corp
CUI	Currie Rose Resources Inc
CUO	Copper One Inc
CUU	Copper Fox Metals Inc
CUV	Cuv Ventures Corp.
CUZ	Cruz Cobalt Corp
CV.H	Chantrell Ventures Corp
CVB	Compass Gold Corporation
CVM	Cvr Medical Corp
CVR	CDN Oil Recovery Remediation Ent Ltd
CVS.P	Canvass Ventures Ltd
CVV	Canalaska Uranium Ltd
CVX	Cematrix Corp
CWC	Cwc Energy Services Corp
CWM	Crown Mining Corp
CWV	Crown Point Energy Inc
CX	Clarmin Explorations Inc
CXB	Calibre Mining Corp
CXO	Colorado Resources Ltd
CYF	Canyon Creek Food Co Ltd
CYL	Ceylon Graphite Corp
CYM	Cymat Technologies Ltd
CYP	Cypress Development Corp
CYX	Calyx Ventures Inc.
CZO	Ceapro Inc
CZQ.H	Continental Precious Minerals Inc
CZZ	Cleghorn Minerals Ltd
DAC	Datable Technology Corp.
DAL	Dalmac Energy Inc
DAN	Arianne Phosphate Inc
DAP.U	Xpel Technologies Corp
DAR	Darelle Online Solutions Inc
DASH	Neptune Dash Technologies Corp
DAU	Desert Gold Ventures Inc
DBD.H	Darien Business Development Corp
DBV	Doubleview Capital Corp
DCOP	District Copper Corp.
DCY	Discovery-Corp. Enterprises Inc
DE	Decisive Dividend Corp
DEC	Decade Resources Ltd
DEF	Defiance Silver Corp
DELX	Delphx Capital Markets Inc
DEX	Almadex Minerals Ltd
DFR	Diamond Fields Resources Inc.
DFS	Global Daily Fantasy Sports Inc
DGO	Durango Resources Inc
DHR	Discovery Harbour Resources Corp
DIA	Margaret Lake Diamonds Inc
DJI	Dajin Resources Corp
DLC	Dlc Holdings Corp
DLI	Desert Lion Energy Inc.
DLS	Dealnet Capital Corp
DLV.H	Dv Resources Ltd
DM	Datametrex Ai Ltd
DMA	Diamedica Therapeutics Inc
DMC.H	Dataminers Capital Corp
DME	Desert Mountain Energy Corp.
DMG.H	Dmd Digital Health Connections Group Inc
DMGI	Dmg Blockchain Solutions Inc
DMI	Diamcor Mining Inc
DMR	Damara Gold Corp
DNAX	Blockstrain Technology Corp.
DNX	Dynex Power Inc
DOS	Dios Exploration Inc
DPH	Duncan Park Holdings Corp
DRV	Duran Ventures Inc
DSM	Deep South Resources Inc
DSV	Discovery Metals Corp
DSY	Destiny Media Technologies Inc
DUG	Distinct Infrastructure Group Inc
DV	Dolly Varden Silver Corp
DVA	Delivra Corp
DVC.H	Devin Energy Corp
DVG	Divergent Energy Services Corp
DVI	Dunnedin Ventures Inc
DVT	Divestco Inc
DWS	Diamond Estates Wines and Spirits Inc
DXA	Doxa Energy Ltd
DXX	Dxstorm.Com Inc.
DYA	Dynacert Inc
DYG	Dynasty Gold Corp
EAM	East Africa Metals Inc
EAS	East Asia Minerals Corp
EAST	Harbour Star Capital Inc
EAU	Engineer Gold Mines Ltd
EBM	Eastwood Bio Medical Canada Inc
EBY	Emerald Bay Energy Inc
ECC	Ethos Gold Corp
ECM	Ecolomondo Corporation
ECR	Cartier Resources Inc
ECT	Ellipsiz Communications Ltd
EDG	Endurance Gold Corp
EDW.H	Edgewater Exploration Ltd
EGA	Eagle Graphite Incorporated
EGD	Energold Drilling Corp
EGM	Engold Mines Ltd
EGT	Eguana Technologies Inc
EH.P	Elephant Hill Capital Inc
EHT	Enerdynamic Hybrid Tech Corp
EIL	Empire Industries Ltd
EKG	Cardiocomm Solutions Inc
EL	Engagement Labs Inc
ELC	Elysee Development Corp
ELM	Element Lifestyle Retirement Inc
ELN	El Nino Ventures Inc
ELO	Eloro Resources Ltd
ELT	Electra Stone Ltd
ELY	Ely Gold Royalties Inc.
EMC	Emblem Corp
EMC.WT	Emblem Corp Wts
EMC.WT.A	Emblem Corp Wts
EMC.WT.B	Emblem Corp Wts B
EMH	Emerald Health Therapeutics Inc
EMO	Emerita Resources Corp
EMR	Emgold Mining Corp
EMX	Emx Royalty Corp
ENA	Enablence Technologies Inc
ENER	Enerspar Corp
ENRG	New Energy Metals Corp.
ENV.H	Enssolutions Group Inc
ENW	Enwave Corp
ENW.WT	Enwave Corporation Wts
EOG	Eco Atlantic Oil and Gas Ltd
EP	Empire Metals Corp
EPI	Essa Pharma Inc
EPL	Eagle Plains Resources Ltd
EPO	Encanto Potash Corp
EPWR	Epower Metals Inc.
EQ	Eq Inc
EQG	Eqube Gaming Limited
EQX	Equinox Gold Corp.
EQX.WT	Equinox Gold Corp Wts
ERA	Elcora Advanced Materials Corp
ERC	Eros Resources Corp
ERE.UN	European Commercial REIT
ERL.H	Earl Resources Limited
ES	Eight Solutions Inc
ESK	Eskay Mining Corp
ESR	Esrey Resources Ltd.
ESS	Esstra Industries Inc.
ESU	Eestor Corp
ESV	Esi Environmental Sensors Inc
ESX	Essex Minerals Inc
ETF	Eastfield Resources Ltd
ETMC	E3 Metals Corp
EU	Encore Energy Corp
EUO	Eurocontrol Technics Group Inc
EV	Erin Ventures Inc
EVE	Eve and Co Incorporated
EVM	Evrim Resources Corp
EVR	Everton Resources Inc
EVX	European Electric Metals Inc.
EW	East West Petroleum Corp
EWK	Earthworks Industries Inc
EWS	Environmental Waste International Inc
EXG	Exgen Resources Inc
EXS	Explor Resources Inc
EXX	Equitorial Exploration Corp
EYC	Eyecarrot Innovations Corp
F	Fiore Exploration Ltd
FA	Fountain Asset Corp
FBF	Fab-Form Industries Ltd
FBX	First Bauxite Corp
FCA	Firm Capital American Realty Part CAD
FCA.U	Firm Capital American Realty Part Corp
FCA.WT.U	Firm Cap American Realty Part Wts USD
FCC	First Cobalt Corp
FCD.UN	Firm Capital Property Trust
FCF	Founders Advantage Capital Corp
FDI	Findev Inc
FE	First Energy Metals Limited
FEO	Oceanic Iron Ore Corp
FEX	Fjordland Exploration Inc
FG	Falcon Gold Corp
FGC	Frontline Gold Corp
FGR	Fengro Industries Corp.
FIL	Filo Mining Corp
FIRE	The Supreme Cannabis Company Inc.
FISH	Sailfish Royalty Corp
FIX	Firebird Resources Inc
FL	Frontier Lithium Inc
FLGC	Fanlogic Interactive Inc
FLM	First Legacy Mining Corp
FLT	Drone Delivery Canada Corp
FLY	Flyht Aerospace Solutions Ltd
FMC	Forum Energy Metals Corp.
FMG	First Mexican Gold Corp
FMR	Fairmont Resources Inc
FMS	Focus Graphite Inc
FMV.P	Foremost Ventures Corp
FNC	Fancamp Exploration Ltd
FNR	49 North Resources Inc
FO	Falcon Oil & Gas Ltd
FOM	Foran Mining Corp
FOR	Fortune Bay Corp
FP	Fp Newspapers Inc
FPC	Falco Resources Ltd
FPC.WT	Falco Resources Ltd Wts
FPX	Fpx Nickel Corp
FRE	Fremont Gold Ltd
FREE	Freedom Energy Inc
FRI	Freeport Resources Inc
FRN	Feronia Inc
FSW	Fireswirl  Technologies Inc
FTEC	Fintech Select Ltd
FTI	Fti Foodtech Internation
FTJ	Fort ST James Nickel Corp
FTJ.H	Fort ST James Nickel Corp
FTR	Firesteel Resources Inc
FUND	Katipult Technology Corp
FURA	Fura GEMS Inc.
FUU	Fission 3.0 Corp
FV	Firestone Ventures Inc
FW	Flow Capital Corp
FW.DB.A	Flow Capital Corp 8.0 Pct Debs
FW.DB.B	Flow Capital Corp 7.0 Pct Debs
FWZ	Fireweed Zinc Ltd
FYL	Finlay Minerals Ltd
GAL	Galantas Gold Corp
GAME	Millennial Esports Corp
GAR	Green Arrow Resources In
GAZ.UN	Fronsac Capital REIT Units
GB	Ginger Beef Corp
GBLT	Gblt Corp
GBR	Great Bear Resources Ltd
GBU	Gabriel Res J
GCCC	Gcc Global Capital Corporation
GCN	Goldcliff Resource Corp
GCR	Gespeg Copper Resources Inc
GCX.H	Granite Creek Gold Ltd
GDBO	Gold Rush Cariboo Corp.
GDM	Goldstar Minerals Inc
GDNP	Good Natured Products Inc.
GDP	Golden Pursuit Resources Ltd.
GDX	Goldex Resources Corp
GEL	Tangelo Games Corp
GEMC	Global Energy Metals Corp
GENE	Invictus MD Strategies Corp
GER	Glen Eagle Resources Inc
GFG	Gfg Resources Inc
GG	Galane Gold Ltd
GGG	Graphene 3D Lab Inc
GGI	Garibaldi Resources Corp
GGL	Ggl Resources Corp
GGM	Granada Gold Mine Inc
GGS	Golden Secret Ventures Ltd
GGX	Ggx Gold Corp
GHR.H	Golden Harp Resources Inc
GIGA	Giga Metals Corp
GIII	Gen III Oil Corp
GIS	Genesis Metals Corp
GIT	Gitennes Exploration Inc
GLB	Goldbank Mining Corp
GLD	Goldon Resources Ltd
GLDN	Golden Ridge Resources Ltd
GLI	Glacier Lake Resources Inc
GLIN.P	Global Investments Capital Corp
GLK	Great Lakes Graphite Inc
GLO	Global Atomic Corp.
GLW	Galway Gold Inc
GMA	Geomega Resources Inc
GMN	Gobimin Inc
GMV	Gmv Minerals Inc
GNC	Gainey Capital Corp
GNF	Greenfields Petroleum Corp
GNG	Golden Goliath Resources Ltd
GNH	Golden Hope Mines Ltd
GNT	Gentor Resources Inc
GOE	Goldeneye Resources Corp
GOG	Golden Tag Resources Ltd
GOM	Golden Dawn Minerals Inc
GOOD	Good Life Networks Inc
GOP	Gourmet Ocean Products Inc
GOT	Goliath Resources Limited
GOTO.P	Good2Go Corp
GPG	Grande Portage Resources Ltd
GPH	Graphite One Resources Inc
GPLY	Goldplay Exploration Ltd.
GPM	Gpm Metals Inc
GPV	Greenpower Motor Company Inc
GPY	Golden Predator Mining Corp
GQ	Great Quest Fertilizer Ltd
GQC	Goldquest Mining Corp
GR	Great Atlantic Resources Corp
GRA	Nanoxplore Inc
GRAT	Gratomic Inc.
GRB	Greenbriar Capital Corp
GRCC.P	Green Rise Capital Corporation
GRDM	Grid Metals Corp.
GRG	Golden Arrow Res Corp
GRI	Galore Resources Inc
GRK	Gray Rock Resources Ltd
GRO	Growmax Resources Corp
GROW	Co2 Gro Inc
GRR	Golden Reign Resources Ltd
GRX.H	Greenshield Explorations Limited
GRZ	Gold Reserve Inc
GSA	Groundstar Resources Ltd
GSD	Devonian Health Group Inc
GSH	Golden Share Resources Corp
GSI	Gatekeeper Systems Inc
GSP	Gensource Potash Corp
GSR	Goldstrike Resources Ltd
GSS	Gossan Resources Limited
GSX.H	Goldstream Minerals Inc
GTA	Gta Resources and Mining Inc
GTB	Greatbanks Resources Ltd
GTC	Getty Copper Inc
GTEC	Gtec Holdings Ltd.
GTG	Great Thunder Gold Corp
GTT	GT Gold Corp
GUG	Gungnir Resources Inc
GUN	Gunpoint Exploration Ltd
GUS.P	Angus Ventures Inc
GV	Guerrero Ventures Inc
GVG	Grenville Gold Corp.
GVR	Grosvenor Resources Corp
GVY	Green Valley Mine Incorporated
GWA	Gowest Gold Ltd
GWM	Galway Metals Inc
GXL	Galileo Exploration Ltd
GXR	Georox Resources Inc
GXS	Goldsource Mines Inc
GXU	Goviex Uranium Inc
GYA	Guyana Goldstrike Inc
GZD	Grizzly Discoveries Inc
GZZ	Golden Valley Mines Ltd
HAN	Hannan Metals Ltd
HAND	Handa Mining Corp.
HAR	Harfang Exploration Inc
HAW.P	Haw Capital Corp
HAWK	Hawkeye Gold and Diamond Inc
HBE	Hornby Bay Mineral Exploration Ltd
HBK	Highbank Resources Ltd
HEI	Huntington Exploration Inc
HEM	Hemostemix Inc
HEMP	Hempco Food and Fiber Inc
HEO	H2O Innovation Inc
HFC	Hampton Financial Corp
HFC.PR.A	Hampton Financial Corporation Pref A
HI	Highland Copper Company Inc
HIP	Newstrike Resources Ltd
HIP.WT	Newstrike Resources Ltd Wts
HIP.WT.A	Newstrike Resources Ltd Wts A
HIT	Hit Technologies Inc
HIVE	Hive Blockchain Technologies Inc.
HIVE.WT	Hive Blockchain Technologies Ltd Wts
HJI	Helijet International Inc
HLS	Hls Therapeutics Inc.
HMC	Havilah Mining Corporation
HME	Hemisphere Energy Corp
HMI	Hinterland Metals Inc
HMT	Halmont Properties Corp
HMX	Hunt Mining Corp
HOC	Hunter Oil Corp
HPI	Highbury Projects Inc.
HPL	Horizon Petroleum Ltd
HPQ	Hpq Silicon Resources Inc
HPY	Happy Creek Minerals Ltd
HRC	Helio Res Corp
HRE	Stans Energy Corp
HRH	Hillcrest Petroleum Ltd
HRL	Hansa Resources Limited
HSI	H Source Holdings Ltd
HTC	Htc Purenergy Inc
HTL	Hamilton Thorne Ltd
HTR	Heatherdale Resources Ltd
HUD	Hudson Resources Inc
HUT	Hut 8 Mining Corp
HVG	Harvest Gold Corp
HVT	Harvest One Cannabis Inc
HVT.WT	Harvest One Cannabis Inc Wts
HVT.WT.A	Harvest One Cannabis Inc Wts A
HWY	Highway 50 Gold Corp
HXC	Hfx Holding Corp
HZ	Hybrid Minerals Inc.
IB	Ibc Advanced Alloys Corp
IB.DB	Ibc Advanced Alloys Corp 8.25 Pct Debs
IBC	International Bethlehem Mining Corp
IBT	Ibex Technologies Inc
IC	International Corona Capital Corp
ICAU	Intercontinental Gold and Metals Ltd.
ICC	Icc Labs Inc.
ICI.P	Inceptus Capital Ltd
ICL	Itasca Capital Ltd
ICM	Iconic Minerals Ltd
ICO	Ico Therapeutics Inc
ID	Identillect Technologies Corp
IDH.H	Idg Holdings Inc.
IDI	Indico Resources Ltd
IDM	Idm Mining Ltd
IEI	Imperial Equities Inc
IES	Intercept Energy Services Inc
IFD.H	Intrinsic4D Inc
IFOS	Itafos
IFR	International Frontier Resources Corpora
IFX	Imaflex Inc
IGAM	Integrity Gaming Corp.
IGC.H	Igc Resources Inc
IGO	Independence Gold Corp
IGP	Imperial Ginseng Products Ltd
IGX	Intelgenx Technologies Corp
IGX.DB	Intelgenx Technologies Corp 8.0 Pct Debs
IKM	Ikkuma Resources Corp
ILA	Ilookabout Corp
ILC	International Lithium Corp
ILI	Infinite Lithium Corp.
IMA	I-Minerals Inc
IMEX	Imex Systems Inc
IMI	International Millennium Mining Corp
IMIN	Imining Blockchain & Cryptocurrency Inc.
IMR	Imetal Resources Inc
IMT	International Montoro Res. Inc
INP	Input Capital Corp
INX	Intouch Insight Ltd
IO	Inca One Gold Corp
ION	Alset Minerals Corp
IOT	Innovotech Inc
IOU	Iou Financial Inc
IPA	Immunoprecise Antibodies Ltd
IPC	Iplayco Corporation Ltd
IPD	International Parkside Products Inc
IPG	Imperial Mining Group Ltd
IPT	Impact Silver Corp
IQ	Airiq Inc
IRC	Ironside Resources Inc
IRI	Iemr Resources Inc
IRO	Inter-Rock Minerals Inc
IRR	Inform Resources Corp
ISD	Isign Media Solutions Inc
ISO	Isoenergy Ltd
ISS	International Samuel Exploration Corp
ITG	Intact Gold Corp
ITM	Intema Solutions Inc
ITR	Integra Resources Corp.
ITT	Internet of Things Inc
IVI	Ivrnet Inc
IVS	Inventus Mining Corp
IXI	Indigo Exploration Inc
IZ	International Zeolite Corp.
IZN	Inzinc Mining Ltd
IZZ	International Prospect Ventures Ltd
JADE	Jade Leader Corp.
JAEG	Jaeger Resources Corp.
JAX	Jaxon Mining Inc
JCO	Jericho Oil Corp
JDN	Jayden Resources Inc
JEC	Jura Energy Corp
JET	Canada Jetlines Ltd
JET.WT	Canada Jetlines Ltd Wts
JET.WT.A	Canada Jetlines Ltd Wts A
JFC	Jaguar Financial Corp
JG	Japan Gold Corp
JLR.H	Jiulian Resources Inc
JNX	Junex Inc
JOR	Jourdan Resources Inc
JP	Jackpot Digital Inc
JP.WT	Jackpot Digital Inc Wts
JSE	Jadestone Energy Inc
JSP	Jasper Mining Corp
JTC	Jemtec Inc
JTR	Greenspace Brands Inc
JTR.WT	Greenspace Brands Inc Wts
JUB	Jubilee Gold Exploration Ltd
JUGR	Juggernaut Exploration Ltd.
JWCA	James E. Wagner Cultivation Corp.
JZR	Jazz Resources Inc
KALY	Kalytera Therapeutics Inc
KAP	Kapuskasing Gold Corp
KAR	Karmin Exploration Inc
KASH	Hashchain Technologyinc
KAY.H	Karsten Energy Corp
KBG	Kings Bay Resources Corp
KBLT	Cobalt 27 Capital Corp
KBY	Kona Bay Technologies Inc
KC	Kutcho Copper Corp
KCC	Kincora Copper Limited
KDA	Kda Group Inc
KEN	Kenadyr Mining Holdings Corp
KES	Kesselrun Resources Ltd
KFG	Kfg Resources Ltd
KG	Klondike Gold Corp
KGC	Kestrel Gold Inc
KGL	Kilo Goldmines Ltd
KHA.H	Knighthawk Inc
KHRN	Khiron Life Sciences Corp
KLE.H	Kingsland Energy Corp
KLM	Kermode Resources Ltd
KMC.H	Kmt Hansa Corp
KMT	Komet Resources Inc
KNE	Kane Biotech Inc
KNG	Kingsmen Resources Ltd
KNO.H	Cellstop Systems Inc
KNT	K92 Mining Inc
KNX	Knick Exploration Inc
KS	Klondike Silver Corp
KSI	Kneat.Com Inc
KTN	Kootenay Silver Inc
KTN.WT	Kootenay Silver Inc Wts
KTO	K2 Gold Corp
KTR	Kintavar Exploration Inc
KUB	Cub Energy Inc
KUR.H	Kure Technologies Inc
KUT	Redishred Capital Corp
KUU	Kuuhubb Inc
KYS.H	Kaymus Resources Inc
KZD	Kaizen Discovery Inc
LA	Los Andes Copper Limited
LAB	Labrador Gold Corp.
LAD	New Carolin Gold Corp
LAT	Latin American Minerals Inc
LBC	Libero Copper Corporation
LBI	Lions Bay Capital Inc
LBL	Lattice Biologics Ltd
LBY	Liberty One Lithium Corp
LDI	Lithoquest Diamonds Inc.
LEM	Leading Edge Materials Corp
LEN	Lund Enterprises Corp
LEP	Lithium Energy Products Inc
LEXI	Lithium Energi Exploration Inc
LFC.P	22 Capital Corp
LG	Lgc Capital Ltd
LHR	Lakeview Hotel Invest Corp
LHR.DB.C	Lakeview Hotel Invest Corp Ser C Debs
LHR.DB.D	Lakeview Hotel Invest Corp Ser D Debs
LI	American Lithium Corp
LIC	Lico Energy Metals Inc
LIO	Lion One Metals Limited
LIT	Argentina Lithium and Energy Corp
LITH	Lithium Chile Inc.
LIVE	Globalive Technology Inc.
LJ	Lucky Minerals Inc
LL	Canada Rare Earth Corp
LLC	Lorraine Copper Corp
LLG	Mason Graphite Inc
LM	Lingo Media Corp
LMD	Led Medical Diagnostics Inc
LME	Laurion Mineral Exploration Inc
LMG	Lincoln Mining Corp
LMR	Lomiko Metals Inc
LNC	Lithion Energy Corp
LND	Inspira Financial Inc
LOOP	Loopshare Ltd
LOT	Tomagold Corp
LPC	Lorne Park Capital Partners Inc
LPK	Lupaka Gold Corp
LPS	Legend Power Systems Inc
LRA	Lara Exploration Ltd
LRC.H	Lovitt Resources Inc
LRT.DB.G	Lanesborough REIT 5.0 Pct Ser G Debs
LRT.UN	Lanesborough R.E. Investment Trust
LSC	Lsc Lithium Corp
LTE	Lite Access Technologies Inc
LTV	Leonovus Inc
LTX	Labrador Technologies Inc
LTY	Liberty Biopharma Inc
LUM	Lumina Gold Corp
LVWL	Livewell Canada Inc.
LX.H	Lincoln Ventures Ltd
LXE	Leucrotta Exploration Inc
LXG	Lexagene Holdings Inc
M	Mosaic Capital Corp
M.DB	Mosaic Capital Corp 7.0 Pct Debs
MAC	Themac Resources Group Limited
MAD	Miranda Gold Corp
MAE	Maritime Resources Corp
MAH	Marksmen Energy Inc
MAI	Minera Alamos Inc
MAP	Maple Peak Investments Inc
MAT	Matamec Explorations Inc
MAZ.H	Mazarin Inc
MBI	Med Biogene Inc
MBO	Mobio Technologies Inc
MBR.H	Mbmi Resources Inc
MC	M2 Cobalt Group
MCA.H	Milner Consolidated Silver Mines Ltd
MCF	Pinedale Energy Limited
MCG	Mountain China Resorts Holding Ltd
MCI	Minnova Corp
MCLD	Universal Mcloud Corp
MCM.A	Matachewan Cons Mines
MCN	Metron Capital Corp
MCO	Magnolia Colombia Ltd
MCR	Macro Enterprises Inc
MCS	Mcchip Resources Inc
MCU	Mega Copper Ltd.
MCX	Mcorpcx Inc
MD	Midland Exploration Inc
MDE.H	Madeira Minerals Ltd
MDL	Medallion Resources Ltd
MDO	Manado Gold Corp
MDV	Megastar Development Corp
MDX	Medx Health Corp
MED	Medgold Resources Corp
MEK	Metals Creek Resources Corp
MET	Metalore Resources Limited
META	National Access Cannabis Corp
MEX	Mexican Gold Corp
MEZ.H	Mezzotin Minerals Inc
MFM	Marifil Mines Ltd
MFS	Medifocus Inc
MFX	Minfocus Exploration Corp
MGC.H	Midasco Capital Corp
MGG	Minaurum Gold Inc
MGI	Magnum Goldcorp Inc
MGM	Maple Gold Mines Ltd.
MGM.WT	Maple Gold Mines Ltd Wts
MGX.P	Mg Capital Corporation
MGZ.H	Mangazeya Mining Ltd
MHI	Mineral Hill Industries Ltd
MINE	Inomin Mines Inc
MIR	Medmira Inc
MIT	The Mint Corp
MJS	Majestic Gold Corp
MK.H	Mk2 Ventures Ltd
MKA	Mkango Resources Ltd
MKR	Melkior Resources Inc
MKT	Deepmarkit Corp
ML	Millennial Lithium Corp
ML.WT	Millennial Lithium Corp Wts
MLG	ML Gold Corp
MLN	Marlin Gold Mining Ltd
MLR	Melior Resources Inc
MLY	American Cumo Mining Corp
MMA	Midnight Sun Mining Corp
MMG	Metallic Minerals Corp
MML.P	Magnitude Mining Ltd
MMM	Minco Gold Corp
MMN	Monarca Minerals Inc
MMO.H	Mount Dakota Energy Corp
MMS	Macarthur Minerals Limited
MMV	Mineral Mountain Resources Ltd
MMX	Maverix Metals Inc
MMY	Monument Mining Limited
MN	Manganese X Energy Corp
MNO	Meridian Mining Societas Europaea
MNX	Manitex Capital Inc
MNY	Montan Mining Corp
MOE.H	Metropolitan Energy Corp
MOL	Molori Energy Inc
MON	Montero Mining and Exploration Ltd
MOO	Mooncor Oil and Gas Corp
MOON	Blue Moon Zinc Corp
MOS	Mobi724 Global Solutions Inc
MOX	Morien Resources Corp
MPH	Medicure Inc
MPT	Midpoint Holdings Ltd
MQR	Monarques Gold Corp
MQX	Marquee Energy Ltd
MRL	Margaux Resources Ltd
MRO	Millrock Resources Inc
MRS	Mission Ready Solutions Inc.
MRZ	Mirasol Resources Ltd
MSA	Mesa Exploration Corp
MSP	Minaean SP Construction Corp
MSR	Minsud Resources Corp
MTA	Metalla Royalty & Streaming Ltd
MTB	Mountain Boy Minerals Ltd
MTC	Metalcorp Ltd
MTH	Mammoth Resources Corp
MTO	Metanor Res Inc
MTS	Metallis Resources Inc
MTT	Magna Terra Minerals Inc
MTU	Manitou Gold Inc
MTX	Metalex Ventures Ltd
MUN	Mundoro Capital Inc
MUR	Murchison Minerals Ltd
MVI.H	Monitor Ventures Inc
MVN	Madalena Energy Inc
MVP	Mediavalet Inc
MVY	Moovly Media Inc
MWI.UN	Maplewood International REIT
MWX	Mineworx Technologies Ltd
MXX	Matrrix Energy Technologies Inc
MYA	Maya Gold & Silver Inc
MZZ	Val Dor Mining Corp
N	Namaste Technologies Inc.
N.WT	Namaste Technologies Inc. Wts
NAM	New Age Metals Inc
NAN	North American Nickel Inc
NAP	Napier Ventures Inc
NAR	North Arrow Minerals Inc
NAVN.P	Navion Capital Inc
NBR	Nubian Resources Ltd
NBVA	Nubeva Technologies Ltd.
NBY	Niobay Metals Inc
NCI	Ntg Clarity Networks Inc
NCX	Northisle Copper and Gold Inc
NDR	New Dimension Resources Ltd
NDVA	Indiva Limited
NDVA.WT	Indiva Limited Wts
NED	New Destiny Mining Corp.
NEE	Northern Vertex Mining Corp
NEM	New Era Minerals Inc
NEV	Nevada Sunrise Gold Corp
NFD.A	Northfield Capital Corp Cl.A Rv
NGC	Northern Graphite Corp
NGE	Nevada Exploration Inc
NGH.H	Nexia Health Technologies Inc
NGZ	NRG Metals Inc
NIC	Pure Nickel Inc
NIM	Nicola Mining Inc
NINE	Delta 9 Cannabis Inc
NINE.WT	Delta 9 Cannabis Inc Wts
NIO	Niocan Inc
NIP	Nippon Dragon Resources Inc
NIR	Noble Iron Inc
NKW	Naikun Wind Energy Group Inc
NL	Northern Lion Gold Corp
NLC	NEO Lithium Corp
NLH	Nova Leap Health Corp
NM	Northern Empire Resources Corp
NMG	Noble Metal Group Inc
NMI	Namibia Critical Metals Inc.
NNA	New Nadina Explorations Limited
NNN	Nickel One Resources Inc
NNO	Nano One Materials Corp
NNX	Nickel North Exploration Corp
NOB	Noble Mineral Exploration Inc
NOL.H	Knol Resources Corp
NOT	Noront Resources Ltd
NOU	Nouveau Monde Graphite Inc
NPA	Alphinat Inc
NRG	Newrange Gold Corp
NRM	Noram Ventures Inc
NRN	Northern Shield Resources Inc
NRTH	48North Cannabis Corp
NSP	Naturally Splendid Enterprises Ltd
NSX	Nsgold Corp
NTE	Network Media Group Inc
NTN.H	Newton Energy Corporation
NTQ	Novateqni Corp
NTRL	Sweet Natural Trading Co.
NTS	Nanotech Security Corp
NTY	92 Resources Corp
NU	Neutrisci International Inc
NUAG	New Pacific Metals Corp
NUG	Nulegacy Gold Coporation
NVH	Novoheart Holdings Inc
NVI	Novra Technologies Inc
NVM	Nevada Clean Magnesium Inc
NVO	Novo Resources Corp
NVT	Nortec Minerals Corp
NVV	Norvista Capital Corp
NVX	Nv Gold Corp
NVY	Navy Resources Corp
NW	New World Resources Corp
NWE	New West Energy Services Inc
NWX	Newport Exloration Ltd
NXG	Nexgenrx Inc
NXN	Nxgold Ltd
NXO	Nexoptic Technology Corp
NXR.UN	Nexus Real Estate Investment Trust
NXS	Nexus Gold Corp
NXT	Natcore Technology Inc
NZ	New Zealand Energy Corp
NZN	Nevada Zinc Corp
NZP	Chatham Rock Phosphate Limited
NZZ	Nitinat Minerals Corp
OCC.P	Owl Capital Corp
OCN	Oceanus Resources Corp
OCO	Oroco Resource Corp
ODX.H	Odyssey Resources Ltd
OEE	Memex Inc
OG	Organic Garage Ltd
OGI	Organigram Holdings Inc
OGI.DB	Organigram Holdings Inc 6.00 Pct Debs
OGI.WT.A	Organigram Holdings Inc Wts
OGO	Organto Foods Inc
OIC	Origin Gold Corporation
OK	Ok2 Minerals Ltd
OLA	Orla Mining Ltd
OLV	Olivut Resources Ltd
OM	Osisko Metals Incorporated
OML	Omni-Lite Industries Canada Inc
OMM	Omineca Mining and Metals Ltd
ONE	01 Communique Laboratory Inc
ONV	Oronova Energy Inc
OOO	Otis Gold Corp
OOR	Opus One Resources Inc
OPW	Opawica Explorations Inc
ORC.B	Orca Exploration Group Inc Cl B
ORE	Orezone Gold Corp
ORG	Orca Gold Inc
ORM	Orford Mining Corporation
ORO	New Oroperu Resources Inc
ORS	Orestone Mining Corp
ORX	Orefinders Resources Inc
OS	Osprey Gold Development Ltd
OSI	Osino Resources Corp
OSS	Onesoft Solutions Inc
OSU	Orsu Metals Corp
OVT	Oculus Visiontech Inc
OWL.P	Two Owls Ventures Corp
OY	Oyster Oil and Gas Ltd
OYL	Cgx Energy Inc
PA	Palamina Corp
PAC	Pacton Gold Inc
PAD	Pan Andean Minerals Ltd
PAL	Parallel Mining Corp
PAM	Power Americas Minerals Corp
PAN	Pangolin Diamonds Corp
PAS	Pascal Biosciences Inc
PAT	Patriot One Technologies Inc
PAT.WT	Patriot One Technology Inc Wts
PAT.WT.A	Patriot One Technologies Inc Wts A
PAT.WT.B	Patriot One Technologies Inc Wts B
PBM	Pacific Bay Minerals Ltd
PBR	Para Resources Inc
PBS	Pacgen Life Science Corp
PBX	Powerband Solutions Inc
PCI	Perlite Canada Inc
PCO	Phoenix Canada Oil Co.Ltd.
PCQ	Petrolympic Ltd
PCR	Pinecrest Resources Ltd
PDH	Premier Diversified Holdings Inc
PDP	Pediapharm Inc
PDQ	Petrodorado Energy Ltd
PE	Pure Energy Minerals Limited
PEA	Pieridae Energy Ltd.
PED.H	Pedro Resources Ltd
PEEK	Peeks Social Ltd
PEH	Primeline Energy Holdings Inc
PEI	Prospera Energy Inc.
PEMC	Pacific Empire Minerals Corp
PEO	People Corp
PERU	Chakana Copper Corp.
PEX	Pacific Ridge Exploration Ltd
PFC	Petrofrontier Corp
PFM	Prontoforms Corp
PGC	Plato Gold Corp
PGE	Group Ten Metals Inc
PGM	Pure Gold Mining Inc
PGV	Prodigy Ventures Inc
PGX	Prosper Gold Corp
PGZ	Pan Global Resources Inc
PHD	Providence Gold Mines Inc
PHI	Philippine Metals Inc
PHM	Protech Home Medical Corp.
PHM.DB	Patient Home Monitoring 7.50 Pct Debs
PJT	Partner Jet Corp
PJX	Pjx Resources Inc
PKC.H	Pacific Link Mining Corp
PKT	Parkit Enterprise Inc
PLA	Plata Latina Minerals Corp
PLAN	Progressive Planet Solutions Inc.
PLU	Plateau Energy Metals Inc.
PLX	Point Loma Resources Ltd
PLY	Playfair Mining Ltd
PML	Panoro Minerals Ltd
PMO.H	Prime City One Capital Corp
PMX	Proam Exploration Corp
PN.P	Platform 9 Capital Corp
PNG	Kraken Robotics Inc.
PNN	Pennine Petroleum Corp
PNO	Pentanova Energy Corp
PNO.WT	Pentanova Energy Corp Wts
POC	Pacific Iron Ore Corp
POE	Pan Orient Energy Corp
POG	Perisson Petroleum Corp
POI.H	Pounce Technologies Inc
POND	Pond Technologies Holdings Inc.
POOL	Pool Safe Inc
POR	Portofino Resources Inc
PORE	Powerore Inc
PP	Pacific Silk Road Res Group Inc.
PPE.H	Pacific Paradym Energy Inc
PPK	Prospect Park Capital Corp
PPM	Pacific Imperial Mines Inc
PPV.H	P and P Ventures Inc
PPX	Ppx Mining Corp
PQE	Petroteq Energy Inc
PRB	Probe Metals Inc
PRED.P	Predator Blockchain Capital Corp
PRG	Precipitate Gold Corp
PRH	Pearl River Holdings Limited
PRN	Profound Medical Corp
PRO	Pershimex Resources Corp.
PROS	Prosmart Enterprises Inc
PRS	Prism Resources Inc
PRV.UN	Pro Real Estate Investment Trust
PRZ	Prize Mining Corp
PSH	Petroshale Inc
PSL	Prospero Silver Corp
PST	Pistol Bay Mining Inc
PTE	Pioneering Technology Corp
PTF	Pender Growth Fund Inc
PTK	Poet Technologies Inc
PTP	Petrichor Energy Inc
PTU	Purepoint Uranium Group Inc
PUC	Pancontinental Resources Corp.
PUL	Pulse Oil Corp
PUL.WT	Pulse Oil Corp Wts
PUMA	Puma Exploration Inc
PURE	Pure Global Cannabis Inc.
PVF.PR.U	Partners Value Investments Series 1 Pref
PVF.UN	Partners Value Investments  LP
PVF.WT	Partners Value Investments Warrants
PWM	Power Metals Corp
PX	Pelangio Exploration Inc
PXI	Planet Ventures Inc
PYR	Pyrogenesis Canada Inc
QAI.H	Cairo Resources Inc
QGR	Q Gold Resources Ltd
QI	Q Investments Ltd.
QIC	Quantum International Income Corp
QIS	Quorum Information Technologies Inc
QIT	Quinto Resources Inc
QMC	Qmc Quantum Minerals Corp
QMX	Qmx Gold Corp
QNC	Quantum Numbers Corp
QOC.P	Quendale Capital Corp
QPT	Quest Pharmatech Inc
QQ	Quizam Media Corp
QRO	Quadro Resources Inc
QST	Questor Technology Inc
QTA	Quaterra Resources Inc
QYOU	Qyou Media Inc
RAB	Rambler Metals and Mining Plc
RAK	Rackla Metals Inc
RAU.H	Regency Gold Corp
RB.H	Russell Breweries Inc
RBX	Robex Resources Inc
RCG	Resource Capital Gold Corp
RCK	Rock Tech Lithium Inc
RCLF	Rockcliff Metals Corporation
RCT	Rochester Resources Ltd
RDK.H	Redhawk Resources Inc
RDR.P	Rider Investment Capital Corp
RDS	Radisson Mining Resources Inc
RDU	Radius Gold Inc
REG	Regulus Resources Inc
REKO	Reko International Group Inc
REL	Roughrider Exploration Limited
REN	Renaissance Gold Inc
REW	Rewardstream Solutions Inc
REX	Orex Minerals Inc
REZ	Redzone Resources Ltd
RFC	Rifco Inc
RG	Romios Gold Resources Inc
RGC	Redstar Gold Corp
RGD	Reunion Gold Corp
RGI	Reco International Group Inc
RGZ.H	Randsburg International Gold Corp
RHC	Rhc Capital Corp
RHT	Reliq Health Technologies Inc
RHV.P	Rainy Hollow Ventures Inc
RIO	Rio2 Limited
RJX.A	Rjk Explorations Ltd Cl.A Sv
RK	Rockhaven Resources Ltd
RKR	Rokmaster Resources Corp
RLV	Relevium Technologies Inc
RLY	Riley Resources Corp
RM	Routemaster Capital Inc
RMD	Richmond Minerals Inc
RMK	Red Moon Resources Inc
RML	Rusoro Mining Ltd
RMO	Rainy Mountain Royalty Corp
RNP	Royalty North Partners Ltd
ROC.H	Red Oak Mining Corp
ROCK	Rockridge Resources Ltd.
ROE	Renaissance Oil Corp
ROE.WT	Renaissance Oil Corp Wts
ROE.WT.A	Renaissance Oil Corp Wts A
ROE.WT.B	Renaissance Oil Corp Wts B
ROI	Route1 Inc
ROS	Roscan Minerals Corp
ROT	Rotation Minerals Ltd
ROVR	Rover Metals Corp
RP	Replicel Life Sciences Inc
RPC	Raise Production Inc
RPP	Regent Pacific Properties Inc
RPX	Red Pine Exploration Inc
RRI	Riverside Resources Inc
RRL	Relentless Resources Ltd
RRM.H	Ross River Minerals Inc
RRR.UN	R and R Real Estate Investment Trust
RRS	Rogue Resources Inc
RSS	Resaas Services Inc
RST	Rosita Mining Corp
RSV	Resolve Ventures Inc
RSY	Rsi International Systems Inc
RTH	Rathdowney Resources Ltd
RTI	Radient Technologies Inc
RTM	Rt Minerals Corp
RTN	Return Energy Inc
RUF.DB.U	Pure Multi Family REIT LP 6.5 Pct Dbs
RUF.U	Pure Multi Family REIT LP
RUF.UN	Pure Multi Family REIT LP CAD
RUG	Rugby Mining Limited
RUM	Rocky Mountain Liquor Inc
RUM.DB.A	Rocky Mountain Liquor Inc 7.5 Pct Debs
RUN	Running Fox Resource Corp
RUP	Rupert Resources Ltd
RVG	Revival Gold Inc
RVL	Revelo Resources Corp
RVV	Revive Therapeutics Ltd
RW	Renoworks Software Inc
RWR	Rockwealth Resources Corp
RX	Biosyent Inc
RYE	Rhyolite Resources Ltd
RYO	Rio Silver Inc
RYP.H	Ripper Oil and Gas Inc
RYR	Royal Road Minerals Limited
RYU	Ryu Apparel Inc
RZE	Razor Energy Corp
RZL	Rizal Resources Corp
RZZ	Abitibi Royalties Inc
SA	Southern Arc Minerals Inc
SAC.P	Savanna Capital Corp
SAE	Sable Resources Ltd
SAH	Sahara Energy Ltd
SAT	Asian Television Network Int Ltd
SAY	Sparta Capital Ltd
SB	Stratabound Minerals Corp
SBCC.P	Spirit Banner Capital Corp
SBM	Sirona Biochem Corp
SBW	Strongbow Exploration Inc
SC.H	Serrano Resources Ltd
SCA	Savary Gold Corp
SCD	Samoth Oilfield Inc.
SCH.P	Schooner Capital Corp
SCR	Thescore Inc
SCYB	Scythian Biosciences Corp
SCZ	Santacruz Silver Mining Ltd
SDC	Solidusgold Inc
SDE	Standard Exploration Ltd
SDR	Stroud Resources Ltd
SDX	Sdx Energy Inc
SDZ	Security Devices International Inc
SEB	Smart Employee Benefits Inc
SEI	Sintana Energy Inc
SEK	Secova Metals Corp
SFI	Solution Financial Inc
SFR	Sandfire Resources America Inc.
SFT	Softrock Minerals Ltd
SFX	Sphinx Resources Ltd
SGA	Samco Gold Limited
SGC	Solstice Gold Corp
SGE	Strategem Capital Corp
SGI	Superior Gold Inc
SGM	Sutter Gold Mining Inc
SGMA	Sigma Lithium Resources Corp.
SGN	Scorpio Gold Corp
SGU	Signature Resources Ltd
SGW	Shoal Games Ltd
SGX	Sage Gold Inc
SGZ	Sego Resources Inc
SHJ	Shoshoni Gold Ltd
SHL	Spruce Ridge Resources Ltd
SHM	Synstream Energycorp
SIC	Sokoman Iron Corp
SIE	Sienna Resources Inc
SIL	Silvercrest Metals Inc
SIL.WT	Silvercrest Metals Inc Wts
SILV.H	Caracara Silver Inc
SIM	Siyata Mobile Inc
SIQ	Siq Mountain Industries Inc.
SIR	Serengeti Resources Inc
SJL	Saint Jean Carbon Inc
SJR.A	Shaw Communications Inc
SKE	Skeena Resources Limited
SKP	Strikepoint Gold Inc
SLAU	Sandy Lake Gold Inc
SLK	Silk Road Energy Inc
SLL	Standard Lithium Ltd
SMB	Simba Essel Energy Inc
SMD	Strategic Metals Ltd
SME	Sama Resources Inc Ressources Sama Inc
SMI	Saturn Oil and Gas Inc
SMM	Silver Mountain Mines Inc
SMN	San Marco Resources Inc
SMO	Sonoro Metals Corp
SMS	Sustainco Inc
SMY	Search Minerals Inc
SN	Sennen Potash Corp
SNF	Sunora Foods Inc
SNG	Silver Range Resources Ltd
SNI.PR.A	Sonor Investments Limited
SNM	Shamaran Petroleum Corp
SNR	Senator Minerals Inc
SNS	Select Sands Corp
SNV	Sonoro Energy Ltd
SNX.H	Sixonine Ventures Corp
SOC	Sonora Gold & Silver Corp
SOCK	Smooth Rock Ventures Corp.
SOG	Strategic Oil and Gas Ltd
SOI	Sirios Resources Inc
SOJ	Sojourn Explorations Inc
SOLR	Solar Alliance Energy Inc
SPA	Spanish Mountain Gold Ltd
SPD	Silver Predator Corp
SPI	Canadian Spirit Resources Inc
SPK	Sunset Pacific Petroleum Ltd
SPN	Snipp Interactive Inc
SPP	Spot Coffee Canada Ltd
SPS.A	Sportscene Group Inc
SPX	Stellar Africagold Inc
SQD	Sqi Diagnostics Inc
SQG	Spackman Equities Group Inc
SRA	Stria Lithium Inc
SRC	Stakeholder Gold Corp
SRE	Saville Resources Inc
SRG	Srg Graphite Inc
SRI	Sparton Resources Inc
SRJ	Spearmint Resources Inc
SRL	Salazar Resources Limited
SSA	Spectra Inc
SSC	Smartcool Systems Inc
SSE	Silver Spruce Resources Inc
SSG	Sigma Industries Inc
SSP	Sandspring Resources Ltd
SSS	Sunvest Minerals Corp
SSV	Southern Silver Exploration Corp
STA	Sanatana Resources Inc
STAR	Five Star Diamonds Limited
STC	Sangoma Technologies Corp
STH	Stelmine Canada Ltd
STMP	Stamper Oil & Gas Corp.
STR.H	Santa Rosa Resources Corp
STS	South Star Mining Corp
STUS.A	Starlight US Multi Family No 5
STUS.U	Starlight US Multi Family No 5 USD
SUI.H	Superior Mining International Corp
SUNM	Sun Metals Corp.
SUP	Northern Superior Resources Inc
SUR	Surge Exploration Inc.
SURG	Surge Copper Corp.
SUVA.A	Starlight US Multi Family No 1
SVA	Sernova Corp
SVE	Silver One Resources Inc
SVG	Silver Grail Resources Ltd
SVI	Storagevault Canada Inc
SVS	Solarvest Bioenergy Inc
SWA	Sarama Resources Ltd
SXE	Strata X Energy Ltd
SXL	Slam Exploration Inc
SY	Symbility Solutions Inc
SYH	Skyharbour Resources Ltd
SYZ	Sylogist Ltd
SZM	Scozinc Mining Ltd
TAC	Tasca Resources Ltd
TAE.H	Transamerican Energy Inc
TAJ	Tajiri Resources Corp
TAL	Petrotal Corp.
TAN	Tanager Energy Inc
TBP	Tetra Bio Pharma Inc
TBP.WT	Tetra Bio Pharma Inc Wts
TBR	Timberline Resources Corp
TCA	Timia Capital Corp
TCC	Trenchant Capital Corp
TCC.DB	Trenchant Capital Corp 9.0 Pct Debs
TCI	Target Capital Inc
TCO	Transatlantic Mining Corp
TEG.H	Troy Energy Corp
TEK	Tekmodo Industries Inc
TEM	Tembo Gold Corp
TEN	Terraco Gold Corp
TES	Tesoro Minerals Corp
TETH	Tethyan Resources Plc
TG	Trifecta Gold Ltd
TGH	Tornado Global Hydrovacs Ltd
TGR	Tiger International Resources
TGV	Tango Mining Limited
TGX	True North GEMS Inc
THM	Thunder Mountain Gold Inc
THP	Totally Hip Technologies Inc
THRM	Therma Bright Inc.
THX	Thor Explorations Ltd
TIC	Titanium Corporation Inc
TIG	Triumph Gold Corp
TII	Terra Firma Capital Corp
TIL	Till Capital Ltd
TIM	Toachi Mining Inc
TIN	Eurotin Inc
TIP.H	Tyner Resources Ltd
TK	Tinka Resources Ltd
TKU	Tarku Resources Ltd
TKX	Trackx Holdings Inc
TLA	Titan Logix Corp
TLD.H	Triangle Industries Ltd
TLG	Troilus Gold Corp
TLK	Frankly Inc
TLT	Theralase Technologies Inc
TM	Trigon Metals Inc
TMG	Thermal Energy International Inc
TMS	Targeted Microwave Solutions Inc
TNA	Evergreen Gaming Corp
TNO.H	Terreno Resources Corp
TNR	Tnr Gold Corp
TOE	Tri Origin Exploration Ltd
TOM	Tolima Gold Inc
TORQ	Torq Resources Inc
TORR	Torrent Capital Ltd
TPC	Tenth Avenue Petroleum Corp
TR	Troubadour Resources Inc
TRA	Teras Resources Inc
TRAK	Trakopolis Iot Corp
TRM	Trueclaim Exploration Inc
TRO	Taranis Resources Inc
TRS	Tres-Or Resources Ltd
TRU	Trius Investments Inc
TSD	Tsodilo Resources Ltd
TSG	Tristar Gold Inc
TSN	Telson Mining Corp.
TSP	Titan Star Properties Inc
TSP.DB	Titanstar Properties Inc
TTD	Tinkerine Studios Ltd
TTO.H	Atoro Capital Corp
TTR	Titanium Transportation Group Inc
TTZ	Total Telcom Inc
TUD	Tudor Gold Corp
TUF	Honey Badger Exploration Inc
TUO	Teuton Resources Corp
TVI	Tvi Pacific Inc
TVL	Traverse Energy Ltd
TWR	Tower Resources Ltd
TXR	Terrax Minerals Inc
TYE	Troymet Exploration Corp
TYP	Typhoon Exploration Inc
TZM.H	Tanzania Minerals Corp
TZR	Terrace Energy Corp
TZR.DB	Terrace Energy Corp Debs
UCM.H	Upper Canyon Minerals Corp
UCU	Ucore Rare Metals Inc
UFC	Urbanfund Corp
UGD	Unigold Inc
UGE	Uge International Ltd
UHO	United Hunter Oil and Gas Corp
UI	Urbanimmersive Inc
ULI	Ultra Lithium Inc
UNI	Unisync Corp Class B
UNO	Northern Uranium Corp
URC	Uracan Resources Ltd
URZ	Urz Energy Corp
USS	Uniserve Communications Corp
UTY	Unity Energy Corp
UVN	Uravan Minerals Inc
VAL	Valgold Resources Ltd
VAN	Vangold Mining Corp
VANC	Vanc Pharmaceuticals Inc
VAU	Viva Gold Corp.
VAX	Vantex Resources Ltd
VCI	Vitreous Glass Inc
VCV	Vatic Ventures Corp
VCV.RT	Vatic Ventures Corp Rights
VDO.H	Nevado Resources Corporation
VEIN	Enforcer Gold Corp
VENZ	Venzee Technologies Inc.
VERT.H	Vertical Exploration Inc
VG	Volcanic Gold Mines Inc
VGD	Visible Gold Mines Inc
VGL	Vigil Health Solutions Inc
VGM	Global Gardens Group Inc
VGN	Greencastle Res Ltd
VHI	Vitalhub Corp
VIO	Societe D Exploration Miniere Vior Inc
VIPR	Silver Viper Minerals Corp
VIR	Viridium Pacific Group Ltd
VIS	Visionstate Corp
VIT	Victoria Gold Corp
VIV	Avivagen Inc
VLC	Velocity Minerals Ltd
VLI	Vision Lithium Inc.
VLI.WT	Vision Lithium Inc Wts
VLT	Voltaic Minerals Corp
VLU.P	Value Capital Trust
VLV	Venerable Ventures Ltd
VM	Voyageur Minerals Ltd
VML	Viscount Mining Corp
VMY.H	Voice Mobility International Inc
VO	Valore Metals Corp.
VOLT	Volt Energy Corp
VON.P	Von Capital Corp
VONE	Vanadium One Energy Corp
VPI	Vitality Products Inc
VPT	Ventripoint Diagnostics Ltd
VPY	Versapay Corp
VQA	Valterra Resource Corp
VQS	Viq Solutions Inc
VR	Victory Resources Corp
VRO	Valoro Resources Inc.
VRR	Vr Resources Ltd
VRY	Petro Victory Energy Corp
VSR	Vanstar Mining Resources Inc
VTI	Valdor Technology International Inc
VTT	Vendetta Mining Corp
VTX	Vertex Resource Group Ltd.
VUI	Virginia Energy Resources Inc
VUL	Vulcan Minerals Inc
VUX	Vital Energy Inc
VVC	Vvc Exploration Corp
VXL	Vaxil Bio Ltd
VYC	Vanity Capital Inc
WA	Western Atlas Resources Inc.
WAF	West African Resources Ltd
WAR	War Eagle Mining Company Inc
WATR	Current Water Technologies Inc.
WAV.H	Pecap Resources Inc
WAVE	Waverly Pharma Inc.
WBE	Westbond Enterprises Corp
WCC	Consolidated Woodjam Copper Corp
WCE	Wescan Energy Corp
WDG	Giyani Metals Corp
WEB	Westbridge Energy Corp
WED	The Westaim Corp
WEE	Wavefront Technology Solutions Inc
WELL	Wellness Lifestyles Inc
WGF	Wescan Goldfields Inc
WGO	White Gold Corp
WHM	White Metal Resources Corp
WHN	Westhaven Ventures Inc
WHY	West High Yield Resources Ltd
WI	The Western Investment Co of Cda Ltd
WIF.H	Windfire Capital Corp
WIL	Wilton Resources Inc
WKG	Westkam Gold Corp
WKM	West Kirkland Mining Inc
WKM.WT	West Kirkland Mining Inc Wts
WLF	Wolfden Resources Corp
WMD	Weedmd Inc
WMK.H	Whitemud Resources Inc
WML	Wealth Minerals Ltd
WMR	Westminster Resources Ltd
WNDR	The Wonderfilm Media Corporation
WOD.H	Woden Venture Capital Corporation
WOW.A	Wow Unlimited Media Inc Cls A
WPQ	Wpc Resources Inc
WR.H	Worldwide Resources Corp
WRI	Waseco Resources Inc
WRP	Western Pacific Resources Corp
WRR	Walker River Resources Corp
WT.H	Wangton Capital Corp
WTER	The Alkaline Water Co Inc
WTR	Westcore Energy Ltd
XAG	Xtierra Inc
XBC	Xebec Adsorption Inc
XIA	Xiana Mining Inc
XIM	Ximen Mining Corp
XL	Xxl Energy Corp.
XLY	Auxly Cannabis Group Inc.
XLY.WT	Auxly Cannabis Group Inc Wts
XND	Xander Resources Inc
XOP	Canadian Overseas Petroleum Limited
XTM	Transition Metals Corp
XTT	X Terra Resources Inc
XX	Avante Logixx Inc
YAK	Mongolia Growth Group Ltd
YD	Ydreams Global Interactive Tech Inc
YES	Char Technologies Ltd
YFI	Edgewater Wireless Systems Inc
YMI	Yellowhead Mining Inc
YMI.RT	Yellowhead Mining Inc RTS
YNV	Ynvisible Interactive Inc
YOO	Yangaroo Inc
YSC.H	Yongsheng Capital Inc
YTY	Wi2Wi Corp
Z	Zinc One Resources Inc
ZAD	Zadar Ventures Ltd
ZC	Zimtu Capital Corp
ZDC	Zedcor Energy Inc
ZEE	Zenith Energy Ltd
ZEN	Zenyatta Ventures Ltd
ZFR	Zephyr Minerals Ltd
ZKL	China Keli Electric Company Ltd
ZMA	Zoomaway Travel Inc
ZMD	Zoommed Inc
ZMS	Zecotek Photonics Inc
ZNC.H	Zincore Metals Inc
ZNG	Group Eleven Resources Corp
ZNX	Zincx Resources Corp.
ZOM	Zomedica Pharmaceuticals Corp
ZON	Zonte Metals Inc
ZUM	Zoomermedia Limited
